Id,Label,timeset,indegree,outdegree,degree,weighted indegree,weighted outdegree,weighted degree,Eccentricity,closnesscentrality,harmonicclosnesscentrality,betweenesscentrality,modularity_class,componentnumber,strongcompnum,clustering
Mulher_Noticia,Mulher_Noticia,,0,8,8,0,82,82,2,0.681818,0.766667,0,10,0,14,0.017857
contagemcorona1,contagemcorona1,,583,6,589,1929,12,1941,1,1,1,0.000139,10,0,13,0.002265
Bot_Corona_V,Bot_Corona_V,,1,205,206,2,1529,1531,3,0.730415,0.820715,0.000029,0,0,315,0.002702
BrazilSFE,BrazilSFE,,4,4,8,222,408,630,1,1,1,0,0,0,205,0.285714
merial,merial,,5,0,5,345,0,345,0,0,0,0,0,0,201,0.3
kineta,kineta,,3,0,3,255,0,255,0,0,0,0,0,0,204,0.333333
faconti,faconti,,3,2,5,3,7,10,1,1,1,0,88,0,317,0
brasil_io,brasil_io,,10,1,11,58,10,68,0,0,0,0,88,0,316,0.111111
FreitasLuizete,FreitasLuizete,,0,1,1,0,3,3,2,0.545455,0.583333,0,10,0,318,0
viralvideovlogs,viralvideovlogs,,0,133,133,0,264,264,2,0.72093,0.806452,0,10,0,418,0.003418
agenciabrasil,agenciabrasil,,28,5,33,33,14,47,2,0.647059,0.727273,0.000011,4,0,325,0.029234
fiocruz,fiocruz,,161,2,163,201,4,205,1,1,1,0.000004,76,0,67,0.011918
OrighInter,OrighInter,,0,6,6,0,10,10,3,0.538462,0.666667,0,4,0,419,0.1
CandiaCrf,CandiaCrf,,0,5,5,0,40,40,2,0.666667,0.75,0,10,0,420,0.05
GenariSandra,GenariSandra,,0,2,2,0,2,2,2,0.583333,0.642857,0,19,0,421,0
Andersonp1980,Andersonp1980,,0,3,3,0,33,33,2,0.636364,0.714286,0,10,0,422,0.166667
RAQUELD20669859,RAQUELD20669859,,0,1,1,0,4,4,1,1,1,0,0,0,423,0
macaeprefeitura,macaeprefeitura,,4,0,4,11,0,11,0,0,0,0,0,0,302,0
LuciaRSGomes,LuciaRSGomes,,0,3,3,0,5,5,2,0.636364,0.714286,0,10,0,424,0.166667
cansadabh,cansadabh,,0,1,1,0,1,1,2,0.545455,0.583333,0,10,0,425,0
govbr,govbr,,25,0,25,30,0,30,0,0,0,0,4,0,52,0
achagas407,achagas407,,0,3,3,0,3,3,2,0.636364,0.714286,0,10,0,427,0.166667
AlencarBraga13,AlencarBraga13,,6,0,6,6,0,6,0,0,0,0,55,0,426,0
CaioCarlo,CaioCarlo,,0,1,1,0,1,1,2,0.666667,0.75,0,0,0,428,0
secsaudedf,secsaudedf,,10,1,11,17,1,18,1,1,1,0,0,0,314,0.009091
TerraComum,TerraComum,,0,1,1,0,2,2,2,0.545455,0.583333,0,10,0,429,0
tiago_ruu,tiago_ruu,,0,1,1,0,1,1,1,1,1,0,41,0,431,0
tvcultura,tvcultura,,24,0,24,35,0,35,0,0,0,0,41,0,430,0
Paulada22,Paulada22,,0,1,1,0,1,1,1,1,1,0,4,0,432,0
Veniltonleal2,Veniltonleal2,,0,1,1,0,7,7,1,1,1,0,0,0,433,0
governodoamapa,governodoamapa,,3,0,3,16,0,16,0,0,0,0,0,0,295,0
FranBorges78,FranBorges78,,0,7,7,0,9,9,1,1,1,0,1,1,441,0
saudegovpi,saudegovpi,,2,0,2,7,0,7,0,0,0,0,1,1,440,0
rocha_olenka,rocha_olenka,,0,1,1,0,1,1,1,1,1,0,2,2,443,0
SIBI_UFRJ,SIBI_UFRJ,,1,0,1,1,0,1,0,0,0,0,2,2,442,0
jornalistavitor,jornalistavitor,,3,9,12,3,12,15,2,0.909091,0.95,0.000001,19,0,373,0.05303
de_usp,de_usp,,1,0,1,3,0,3,0,0,0,0,19,0,372,0
camposamd,camposamd,,0,2,2,0,11,11,1,1,1,0,41,0,445,0
Wyeth,Wyeth,,5,0,5,171,0,171,0,0,0,0,0,0,203,0.3
Zoetis,Zoetis,,5,0,5,171,0,171,0,0,0,0,0,0,202,0.3
portalhospbra,portalhospbra,,3,0,3,11,0,11,0,0,0,0,0,0,313,0
FeSa972,FeSa972,,0,2,2,0,76,76,2,0.583333,0.642857,0,10,0,446,0
jcelio0123,jcelio0123,,0,1,1,0,2,2,1,1,1,0,88,0,447,0
dra_gioconda,dra_gioconda,,0,1,1,0,1,1,1,1,1,0,4,0,448,0
mqueiroga2,mqueiroga2,,218,0,218,246,0,246,0,0,0,0,4,0,63,0.000169
turicas,turicas,,0,1,1,0,16,16,1,1,1,0,88,0,449,0
FHernandezSilva,FHernandezSilva,,0,1,1,0,1,1,1,1,1,0,4,0,450,0
Erbl1958,Erbl1958,,0,1,1,0,1,1,2,0.545455,0.583333,0,10,0,451,0
Margot13reserva,Margot13reserva,,0,3,3,0,4,4,2,0.615385,0.6875,0,10,0,453,0.166667
bellaciaubella,bellaciaubella,,0,8,8,0,8,8,3,0.518182,0.55848,0,27,0,455,0.196429
CacoBrasil2,CacoBrasil2,,2,5,7,2,5,7,1,1,1,0,88,0,454,0.233333
beattrice_,beattrice_,,7,3,10,12,11,23,2,0.636364,0.714286,0.000002,27,0,71,0.188889
projmandacaru,projmandacaru,,10,0,10,16,0,16,0,0,0,0,213,0,70,0.011111
MaluhMartins1,MaluhMartins1,,0,1,1,0,1,1,1,1,1,0,41,0,456,0
LeNautilus,LeNautilus,,2,2,4,2,3,5,1,1,1,0,3,3,458,0.333333
FoxNews,FoxNews,,1,0,1,2,0,2,0,0,0,0,3,3,457,0
SuzeteMendes12,SuzeteMendes12,,0,1,1,0,1,1,2,0.545455,0.583333,0,10,0,459,0
Emanotel,Emanotel,,1,1,2,1,3,4,2,0.545455,0.583333,0,10,0,312,0.5
DefesaBolsonaro,DefesaBolsonaro,,0,5,5,0,10,10,3,0.590909,0.679487,0,4,0,460,0.25
minsaude,minsaude,,118,0,118,203,0,203,0,0,0,0,4,0,59,0.004491
taniaeginaramos,taniaeginaramos,,0,1,1,0,1,1,2,0.545455,0.583333,0,10,0,461,0
pr_bolsonaro,pr_bolsonaro,,0,2,2,0,2,2,1,1,1,0,4,0,462,0
aurorapolarexp,aurorapolarexp,,0,2,2,0,9,9,1,1,1,0,125,0,464,0
jdoriajr,jdoriajr,,179,0,179,185,0,185,0,0,0,0,125,0,39,0.005461
pedro_orlandini,pedro_orlandini,,0,2,2,0,5,5,2,0.583333,0.642857,0,10,0,465,0
johnlouismanow,johnlouismanow,,0,1,1,0,1,1,2,0.545455,0.583333,0,10,0,466,0
dtferreira,dtferreira,,0,1,1,0,1,1,1,1,1,0,8,0,467,0
Educacao_PT,Educacao_PT,,8,0,8,8,0,8,0,0,0,0,8,0,412,0.017857
Armando62481447,Armando62481447,,0,1,1,0,1,1,1,1,1,0,8,0,468,0
Justkawme,Justkawme,,0,1,1,0,1,1,2,0.571429,0.625,0,5,0,469,0
OPASOMSBrasil,OPASOMSBrasil,,73,3,76,141,5,146,1,1,1,0.000011,5,0,134,0.002281
sra_perola,sra_perola,,0,1,1,0,1,1,1,1,1,0,6,4,471,0
g1campinas,g1campinas,,1,0,1,1,0,1,0,0,0,0,6,4,470,0
norcorr,norcorr,,0,1,1,0,1,1,1,1,1,0,8,0,472,0
marreiros_pedro,marreiros_pedro,,0,1,1,0,1,1,1,1,1,0,8,0,473,0
Vasconc60852362,Vasconc60852362,,0,1,1,0,1,1,1,1,1,0,62,0,475,0
jornal_cultura,jornal_cultura,,20,0,20,25,0,25,0,0,0,0,62,0,474,0
Garcia4251,Garcia4251,,0,2,2,0,2,2,1,1,1,0,45,0,476,0.5
hrw_brasil,hrw_brasil,,5,1,6,5,1,6,1,1,1,0,45,0,452,0.166667
jairbolsonaro,jairbolsonaro,,29,0,29,37,0,37,0,0,0,0,45,0,24,0.014778
NinaHoneyNH,NinaHoneyNH,,0,2,2,0,2,2,1,1,1,0,7,5,479,0
mpdft,mpdft,,1,0,1,1,0,1,0,0,0,0,7,5,478,0
cnpg_oficial,cnpg_oficial,,1,0,1,1,0,1,0,0,0,0,7,5,477,0
govpt,govpt,,22,2,24,25,4,29,1,1,1,0.000002,8,0,413,0.016304
FutureNotPast,FutureNotPast,,0,1,1,0,1,1,1,1,1,0,9,6,481,0
PhilipOLeary11,PhilipOLeary11,,1,0,1,1,0,1,0,0,0,0,9,6,480,0
SafetyUel,SafetyUel,,2,0,2,5,0,5,0,0,0,0,0,0,311,0
DiarioDoRio,DiarioDoRio,,10,5,15,22,6,28,1,1,1,0.000002,0,0,310,0.038095
Prefeitura_Rio,Prefeitura_Rio,,3,0,3,5,0,5,0,0,0,0,0,0,309,0.166667
ecnsoft,ecnsoft,,0,1,1,0,1,1,1,1,1,0,10,0,482,0
roxmo,roxmo,,4,0,4,4,0,4,0,0,0,0,10,0,334,0.083333
vaneasimivrsa,vaneasimivrsa,,0,1,1,0,4,4,1,1,1,0,62,0,483,0
valeria_ypunto,valeria_ypunto,,0,1,1,0,1,1,1,1,1,0,11,7,485,0
sanchezcastejon,sanchezcastejon,,1,0,1,1,0,1,0,0,0,0,11,7,484,0
welldias,welldias,,0,2,2,0,2,2,1,1,1,0,4,0,486,0
FalaBarreiras,FalaBarreiras,,1,0,1,2,0,2,0,0,0,0,0,0,308,0
mondai_puppet,mondai_puppet,,0,1,1,0,8,8,2,0.545455,0.583333,0,10,0,487,0
EstanilauBretas,EstanilauBretas,,0,6,6,0,22,22,4,0.541667,0.685897,0,4,0,488,0.2
istoe_dinheiro,istoe_dinheiro,,5,0,5,11,0,11,0,0,0,0,4,0,48,0
botdocovid,botdocovid,,3,0,3,35,0,35,0,0,0,0,0,0,307,0
Rioparina,Rioparina,,1,1,2,1,2,3,2,0.545455,0.583333,0,10,0,489,0
DeLitaiff,DeLitaiff,,0,3,3,0,3,3,1,1,1,0,25,0,491,0
Luis_Rodrigues_,Luis_Rodrigues_,,0,1,1,0,1,1,2,0.545455,0.583333,0,10,0,492,0
Vovoconsuelo,Vovoconsuelo,,0,1,1,0,1,1,1,1,1,0,4,0,493,0
ricardoalvvesbh,ricardoalvvesbh,,0,3,3,0,3,3,1,1,1,0,12,8,497,0
historia_pensar,historia_pensar,,1,0,1,1,0,1,0,0,0,0,12,8,496,0
MarcianoBrito13,MarcianoBrito13,,4,10,14,14,107,121,3,0.525253,0.580128,0.000001,10,0,99,0.272727
leandro2404,leandro2404,,0,5,5,0,13,13,1,1,1,0,4,0,499,0.05
Eduardo95394084,Eduardo95394084,,0,1,1,0,1,1,1,1,1,0,4,0,500,0
IsraelBrazil2,IsraelBrazil2,,2,0,2,5,0,5,0,0,0,0,0,0,306,0
BlogdoJuares,BlogdoJuares,,1,0,1,7,0,7,0,0,0,0,0,0,305,0
panchocombr,panchocombr,,4,0,4,7,0,7,0,0,0,0,0,0,304,0
veridianavazde,veridianavazde,,0,6,6,0,8,8,2,0.8,0.875,0,62,0,503,0.066667
AfpChecamos,AfpChecamos,,99,2,101,152,3,155,1,1,1,0.000013,62,0,62,0.000594
AndrezaMaior,AndrezaMaior,,0,1,1,0,1,1,2,0.571429,0.625,0,5,0,504,0
opressor_es,opressor_es,,0,5,5,0,9,9,3,0.52,0.641026,0,4,0,505,0.15
DanielGaloMinas,DanielGaloMinas,,0,2,2,0,2,2,3,0.529412,0.592593,0,76,0,506,0
Al54804971,Al54804971,,0,1,1,0,1,1,1,1,1,0,4,0,507,0
Dinda_Cacta,Dinda_Cacta,,0,1,1,0,2,2,2,0.545455,0.583333,0,10,0,508,0
helena_lawyer,helena_lawyer,,0,1,1,0,1,1,1,1,1,0,4,0,509,0
Leonard78336335,Leonard78336335,,0,1,1,0,1,1,1,1,1,0,4,0,510,0
PloegSusana,PloegSusana,,0,2,2,0,2,2,1,1,1,0,5,0,513,0
MSF_brasil,MSF_brasil,,11,0,11,13,0,13,0,0,0,0,5,0,512,0
transitorj,transitorj,,0,4,4,0,7,7,1,1,1,0,4,0,514,0.083333
adrianabpadilha,adrianabpadilha,,0,1,1,0,1,1,2,0.6,0.666667,0,62,0,515,0
LaRouge50698815,LaRouge50698815,,0,1,1,0,1,1,2,0.545455,0.583333,0,10,0,516,0
heraclito_c,heraclito_c,,0,2,2,0,11,11,2,0.583333,0.642857,0,10,0,517,0
Belle01035025,Belle01035025,,0,1,1,0,1,1,2,0.545455,0.583333,0,10,0,518,0
corona_tweet,corona_tweet,,0,31,31,0,33,33,2,0.816327,0.8875,0,0,0,519,0.009677
TVKZ4,TVKZ4,,2,0,2,9,0,9,0,0,0,0,0,0,303,0
33RobertoMT,33RobertoMT,,0,1,1,0,1,1,1,1,1,0,4,0,520,0
FrankAllanRJ,FrankAllanRJ,,2,0,2,2,0,2,0,0,0,0,10,0,417,0
LuizSchettini,LuizSchettini,,0,1,1,0,1,1,1,1,1,0,10,0,521,0
DagobertoP04,DagobertoP04,,0,2,2,0,6,6,2,0.6,0.666667,0,10,0,522,0.5
apampesp_p,apampesp_p,,0,1,1,0,1,1,1,1,1,0,13,9,524,0
Feteerj_oficial,Feteerj_oficial,,1,0,1,1,0,1,0,0,0,0,13,9,523,0
DanAlcaras,DanAlcaras,,6,0,6,51,0,51,0,0,0,0,0,0,301,0
arianelicas,arianelicas,,0,1,1,0,7,7,1,1,1,0,0,0,525,0
FaroldaB,FaroldaB,,3,0,3,25,0,25,0,0,0,0,0,0,300,0
MEDPUCRio,MEDPUCRio,,1,0,1,4,0,4,0,0,0,0,0,0,299,0
cruzeirozip,cruzeirozip,,0,3,3,0,3,3,1,1,1,0,14,10,529,0
csjt_oficial,csjt_oficial,,1,0,1,1,0,1,0,0,0,0,14,10,528,0
CorreaLelio,CorreaLelio,,0,1,1,0,1,1,2,0.545455,0.583333,0,10,0,530,0
ElisetePena,ElisetePena,,0,6,6,0,9,9,2,0.65,0.730769,0,62,0,531,0
UchoInfo,UchoInfo,,5,0,5,6,0,6,0,0,0,0,62,0,187,0.1
jornaljogoserio,jornaljogoserio,,1,0,1,4,0,4,0,0,0,0,0,0,298,0
jacas34,jacas34,,0,1,1,0,1,1,1,1,1,0,25,0,532,0
AiltonBenedito,AiltonBenedito,,596,0,596,635,0,635,0,0,0,0,25,0,364,0.000006
MiraniMota,MiraniMota,,0,1,1,0,1,1,1,1,1,0,25,0,533,0
Soniacapel17,Soniacapel17,,0,1,1,0,1,1,1,1,1,0,4,0,534,0
LiliPalmer19,LiliPalmer19,,0,1,1,0,1,1,1,1,1,0,15,11,536,0
carlaopignatari,carlaopignatari,,1,0,1,1,0,1,0,0,0,0,15,11,535,0
SibneleCalanara,SibneleCalanara,,0,1,1,0,1,1,1,1,1,0,16,12,538,0
nonoinvestidor,nonoinvestidor,,1,0,1,1,0,1,0,0,0,0,16,12,537,0
ProconMaranhao,ProconMaranhao,,2,0,2,6,0,6,0,0,0,0,42,0,416,0
mluciares,mluciares,,0,1,1,0,1,1,2,0.545455,0.583333,0,10,0,539,0
bbetinho13,bbetinho13,,0,1,1,0,1,1,2,0.545455,0.583333,0,10,0,540,0
eu_fa_tima,eu_fa_tima,,0,2,2,0,2,2,2,0.75,0.833333,0,0,0,541,0.5
xico_alexandre,xico_alexandre,,6,3,9,7,6,13,1,1,1,0,0,0,285,0.261905
cirogomes,cirogomes,,6,0,6,9,0,9,0,0,0,0,0,0,235,0.166667
sonia_divinaa,sonia_divinaa,,0,6,6,0,19,19,3,0.5,0.537736,0,10,0,542,0.333333
WagnerTerzi,WagnerTerzi,,0,3,3,0,3,3,1,1,1,0,125,0,544,0.166667
C_trova,C_trova,,1,0,1,1,0,1,0,0,0,0,125,0,543,0
nelsonmffrosa,nelsonmffrosa,,0,2,2,0,5,5,2,0.75,0.833333,0,8,0,545,0.5
StanleyBresh,StanleyBresh,,0,2,2,0,11,11,2,0.583333,0.642857,0,10,0,546,0
riomaframix,riomaframix,,1,0,1,7,0,7,0,0,0,0,0,0,297,0
Lou_novak,Lou_novak,,0,2,2,0,5,5,1,1,1,0,4,0,547,0
Vanderl31693131,Vanderl31693131,,0,1,1,0,1,1,2,0.545455,0.583333,0,10,0,548,0
AndreiaPorto_EU,AndreiaPorto_EU,,0,1,1,0,1,1,2,0.6,0.666667,0,8,0,549,0
gssaraujo,gssaraujo,,0,1,1,0,3,3,2,0.545455,0.583333,0,10,0,550,0
RevistaISTOE,RevistaISTOE,,1,1,2,2,2,4,1,1,1,0,45,0,49,0
cchacalmaster,cchacalmaster,,1,0,1,3,0,3,0,0,0,0,0,0,296,0
001Carlao,001Carlao,,0,1,1,0,1,1,1,1,1,0,4,0,551,0
MariaPAlves_23,MariaPAlves_23,,0,1,1,0,2,2,2,0.545455,0.583333,0,10,0,552,0
sfvanderley,sfvanderley,,1,5,6,1,6,7,1,1,1,0,45,0,26,0.233333
VANDERL34697709,VANDERL34697709,,2,3,5,3,3,6,1,1,1,0,45,0,25,0.3
Vanialulima,Vanialulima,,0,1,1,0,1,1,1,1,1,0,4,0,553,0
bibxisto2021,bibxisto2021,,0,2,2,0,2,2,3,0.444444,0.513889,0,76,0,554,0.5
AlhConsultoria,AlhConsultoria,,1,0,1,1,0,1,0,0,0,0,0,0,294,0
covid19br_,covid19br_,,3,0,3,74,0,74,0,0,0,0,0,0,293,0
MissMoura,MissMoura,,0,1,1,0,1,1,1,1,1,0,4,0,555,0
RaulSilvestre,RaulSilvestre,,0,1,1,0,2,2,2,0.545455,0.583333,0,10,0,556,0
GilmarNery2,GilmarNery2,,0,1,1,0,1,1,1,1,1,0,4,0,557,0
laraia_gama,laraia_gama,,0,1,1,0,1,1,1,1,1,0,17,13,559,0
fatecriopreto,fatecriopreto,,1,0,1,1,0,1,0,0,0,0,17,13,558,0
BandRio,BandRio,,2,0,2,2,0,2,0,0,0,0,10,0,415,0
RodrigoMarch17,RodrigoMarch17,,0,1,1,0,1,1,1,1,1,0,4,0,560,0
LuizdePaula100,LuizdePaula100,,0,3,3,0,59,59,2,0.666667,0.75,0,10,0,561,0.333333
MendesOnca,MendesOnca,,0,1,1,0,5,5,2,0.545455,0.583333,0,10,0,562,0
diegoricardox,diegoricardox,,1,3,4,1,3,4,1,1,1,0,76,0,563,0.166667
agencia_fiocruz,agencia_fiocruz,,126,1,127,139,5,144,1,1,1,0,76,0,67,0.008
leonor_cordeiro,leonor_cordeiro,,1,3,4,2,4,6,2,0.615385,0.6875,0,76,0,84,0.333333
aaananda,aaananda,,0,1,1,0,1,1,2,0.545455,0.583333,0,10,0,564,0
pontodevista_,pontodevista_,,0,1,1,0,1,1,1,1,1,0,18,0,565,0
Folha1_,Folha1_,,4,0,4,4,0,4,0,0,0,0,18,0,292,0
joelsonjosue,joelsonjosue,,0,1,1,0,1,1,2,0.545455,0.583333,0,10,0,566,0
Terezin70546856,Terezin70546856,,0,1,1,0,1,1,1,1,1,0,55,0,567,0
conversa_i,conversa_i,,0,2,2,0,2,2,3,0.482759,0.535714,0,76,0,569,0.5
angelicapinto16,angelicapinto16,,0,1,1,0,1,1,1,1,1,0,41,0,570,0
icarobarbosa5,icarobarbosa5,,0,1,1,0,1,1,1,1,1,0,18,0,571,0
franciscoA2M,franciscoA2M,,0,1,1,0,1,1,1,1,1,0,19,0,573,0
DNDi_Portugues,DNDi_Portugues,,2,0,2,2,0,2,0,0,0,0,19,0,572,0
direitaunidabr1,direitaunidabr1,,2,2,4,2,2,4,1,1,1,0,50,0,575,0.333333
Avnsl10,Avnsl10,,0,1,1,0,1,1,2,0.545455,0.583333,0,10,0,576,0
mjdelfino,mjdelfino,,1,2,3,3,2,5,1,1,1,0,0,0,291,0.333333
revistaoeste,revistaoeste,,4,0,4,4,0,4,0,0,0,0,0,0,290,0.083333
HerminioCerq,HerminioCerq,,3,11,14,7,20,27,2,0.727273,0.8125,0,20,0,396,0.254545
levycorreia,levycorreia,,5,17,22,6,56,62,1,1,1,0.000002,20,0,396,0.108187
palmiralucas8,palmiralucas8,,3,0,3,5,0,5,0,0,0,0,20,0,393,1
IdeiasII,IdeiasII,,3,0,3,9,0,9,0,0,0,0,20,0,395,1
saogama,saogama,,3,0,3,9,0,9,0,0,0,0,20,0,394,1
marialves53,marialves53,,3,0,3,8,0,8,0,0,0,0,20,0,392,1
NatliaPinto2,NatliaPinto2,,3,10,13,9,10,19,2,0.695652,0.78125,0,20,0,396,0.288889
lepetitportcord,lepetitportcord,,3,0,3,8,0,8,0,0,0,0,20,0,391,1
buk3http,buk3http,,3,0,3,7,0,7,0,0,0,0,20,0,390,1
FatimaAntero,FatimaAntero,,2,0,2,6,0,6,0,0,0,0,20,0,389,1
JFSalvandoTodos,JFSalvandoTodos,,0,3,3,0,6,6,2,0.615385,0.6875,0,10,0,577,0
barbarabruzzo,barbarabruzzo,,0,1,1,0,2,2,2,0.545455,0.583333,0,10,0,578,0
IamMarianitta,IamMarianitta,,0,3,3,0,54,54,2,0.666667,0.75,0,10,0,579,0.333333
RodP13,RodP13,,6,11,17,32,124,156,3,0.530612,0.583333,0.000001,27,0,99,0.302198
altinocorreia,altinocorreia,,0,2,2,0,3,3,5,0.361111,0.451282,0,62,0,580,0
palavrastecidas,palavrastecidas,,0,1,1,0,1,1,1,1,1,0,21,14,582,0
RevistaFabra,RevistaFabra,,1,0,1,1,0,1,0,0,0,0,21,14,581,0
Beatrizfisiote1,Beatrizfisiote1,,0,3,3,0,4,4,2,0.615385,0.6875,0,10,0,583,0.333333
AlexandreMHP,AlexandreMHP,,0,2,2,0,10,10,2,0.75,0.833333,0,8,0,584,0.5
SNS_Portugal,SNS_Portugal,,38,0,38,77,0,77,0,0,0,0,8,0,81,0.00569
ReginaC60159030,ReginaC60159030,,0,1,1,0,1,1,1,1,1,0,4,0,585,0
blackca65880998,blackca65880998,,0,2,2,0,2,2,1,1,1,0,76,0,586,1
canalsmais,canalsmais,,1,9,10,5,10,15,1,1,1,0.000001,31,0,278,0
EU_Commission,EU_Commission,,2,0,2,2,0,2,0,0,0,0,31,0,277,0
Jorgete54,Jorgete54,,0,1,1,0,1,1,2,0.545455,0.583333,0,10,0,587,0
guarulhosonline,guarulhosonline,,3,0,3,10,0,10,0,0,0,0,0,0,289,0
DilmaResiste,DilmaResiste,,0,1,1,0,1,1,1,1,1,0,55,0,588,0
flavianunciacao,flavianunciacao,,0,2,2,0,2,2,1,1,1,0,76,0,589,1
KalyLuna2,KalyLuna2,,0,5,5,0,13,13,2,0.647059,0.727273,0,62,0,590,0.15
alex_guerreiro_,alex_guerreiro_,,0,1,1,0,1,1,2,0.6,0.666667,0,8,0,591,0
cearanews7,cearanews7,,1,0,1,1,0,1,0,0,0,0,0,0,288,0
Paulo33600279,Paulo33600279,,0,5,5,0,12,12,2,0.777778,0.857143,0,10,0,592,0.25
yaneerbaryam,yaneerbaryam,,2,0,2,2,0,2,0,0,0,0,10,0,12,0.5
MiguelNicolelis,MiguelNicolelis,,36,2,38,342,3,345,2,0.625,0.7,0.000001,27,0,13,0.078078
Adla45254610,Adla45254610,,0,1,1,0,9,9,1,1,1,0,22,15,594,0
MEZIANE_EMM,MEZIANE_EMM,,2,0,2,12,0,12,0,0,0,0,22,15,593,0
Aaleono1Aaleono,Aaleono1Aaleono,,0,1,1,0,1,1,1,1,1,0,41,0,596,0
socioambiental,socioambiental,,32,0,32,33,0,33,0,0,0,0,41,0,595,0
acg747,acg747,,0,13,13,0,34,34,4,0.517857,0.58908,0,10,0,598,0.089744
Kli_Nev,Kli_Nev,,0,2,2,0,2,2,2,0.75,0.833333,0,0,0,599,0.5
rogoncaetano,rogoncaetano,,0,6,6,0,6,6,1,1,1,0,45,0,603,0
fabiofaria,fabiofaria,,1,0,1,1,0,1,0,0,0,0,45,0,602,0
rogeriosmarinho,rogeriosmarinho,,1,0,1,1,0,1,0,0,0,0,45,0,601,0
folha,folha,,3,0,3,3,0,3,0,0,0,0,45,0,600,0
SoFia55682262,SoFia55682262,,0,1,1,0,1,1,1,1,1,0,4,0,604,0
sergioalb,sergioalb,,0,1,1,0,1,1,1,1,1,0,4,0,605,0
JCadena65913654,JCadena65913654,,0,3,3,0,3,3,1,1,1,0,76,0,606,0.333333
psocialista,psocialista,,0,1,1,0,1,1,2,0.6,0.666667,0,8,0,607,0
health20Paris,health20Paris,,0,1,1,0,1,1,1,1,1,0,23,16,609,0
EricTopol,EricTopol,,1,0,1,1,0,1,0,0,0,0,23,16,608,0
Covid19DailyDta,Covid19DailyDta,,5,0,5,23,0,23,0,0,0,0,0,0,287,0
STF_oficial,STF_oficial,,3,0,3,3,0,3,0,0,0,0,45,0,36,0
Rangel_Lucia,Rangel_Lucia,,0,3,3,0,10,10,2,0.615385,0.6875,0,10,0,610,0
RNPBRASIL,RNPBRASIL,,2,5,7,3,5,8,2,0.619048,0.692308,0.000001,76,0,568,0.142857
Apolo174,Apolo174,,0,3,3,0,3,3,1,1,1,0,27,0,613,0
marcelvanhattem,marcelvanhattem,,1,0,1,1,0,1,0,0,0,0,27,0,612,0
Felnandis24,Felnandis24,,0,1,1,0,1,1,2,0.545455,0.583333,0,10,0,614,0
brabul,brabul,,0,1,1,0,1,1,2,0.571429,0.625,0,5,0,615,0
mss_silveira,mss_silveira,,0,1,1,0,1,1,1,1,1,0,4,0,616,0
liliartes,liliartes,,0,4,4,0,4,4,2,0.642857,0.722222,0,88,0,617,0.166667
siteenfoco,siteenfoco,,1,1,2,1,1,2,0,0,0,0,24,17,618,0
StarsGleaming,StarsGleaming,,3,0,3,6,0,6,0,0,0,0,0,0,286,0
mamjchema,mamjchema,,0,1,1,0,2,2,1,1,1,0,0,0,619,0
robertosimon,robertosimon,,1,0,1,1,0,1,0,0,0,0,27,0,611,0
TaschnerNatalia,TaschnerNatalia,,4,0,4,15,0,15,0,0,0,0,27,0,90,0.083333
AtalaiaBRx,AtalaiaBRx,,0,1,1,0,2,2,1,1,1,0,4,0,620,0
SargentoGarcia,SargentoGarcia,,0,3,3,0,6,6,1,1,1,0,76,0,621,0.333333
netbgomes,netbgomes,,0,1,1,0,3,3,1,1,1,0,8,0,622,0
Anabeaw1,Anabeaw1,,0,1,1,0,2,2,2,0.571429,0.625,0,5,0,623,0
lavinyatagarro_,lavinyatagarro_,,0,2,2,0,20,20,2,0.555556,0.6,0,10,0,624,0
JsLobo_,JsLobo_,,0,1,1,0,1,1,1,1,1,0,25,0,626,0
PlenoNews,PlenoNews,,13,0,13,14,0,14,0,0,0,0,25,0,625,0
emilia_goulart,emilia_goulart,,0,1,1,0,1,1,2,0.571429,0.625,0,5,0,627,0
Icict_Fiocruz,Icict_Fiocruz,,0,3,3,0,11,11,1,1,1,0,76,0,628,0.666667
CanalSaude,CanalSaude,,4,2,6,12,2,14,1,1,1,0,76,0,283,0.2
minions_adriana,minions_adriana,,0,2,2,0,3,3,1,1,1,0,25,0,629,0
bounceimaging,bounceimaging,,2,2,4,2,2,4,1,1,1,0,26,18,630,1
LCGBrands,LCGBrands,,1,1,2,1,1,2,1,1,1,0,26,18,630,0
fiocruzbrasilia,fiocruzbrasilia,,1,2,3,1,3,4,1,1,1,0,76,0,502,0.5
DirOPSPAHO,DirOPSPAHO,,6,0,6,8,0,8,0,0,0,0,5,0,133,0.166667
SaudeGovRS,SaudeGovRS,,9,0,9,19,0,19,0,0,0,0,0,0,284,0
denio_vale,denio_vale,,41,41,82,256,1002,1258,3,0.787879,0.878205,0.000079,27,0,99,0.044429
adaopaiani,adaopaiani,,24,0,24,294,0,294,0,0,0,0,27,0,72,0.103261
nicolaskasprzak,nicolaskasprzak,,24,18,42,294,268,562,3,0.571429,0.650641,0.000013,27,0,99,0.121622
anesalete,anesalete,,0,1,1,0,1,1,2,0.571429,0.625,0,5,0,631,0
Nezeli_Fagundes,Nezeli_Fagundes,,0,3,3,0,3,3,2,0.578947,0.636364,0,62,0,632,0
zeigor00,zeigor00,,0,2,2,0,2,2,1,1,1,0,76,0,633,1
anicaferrero,anicaferrero,,0,1,1,0,1,1,1,1,1,0,4,0,634,0
Mary_joejoe,Mary_joejoe,,0,1,1,0,1,1,1,1,1,0,4,0,635,0
RizzatoMarcello,RizzatoMarcello,,0,1,1,0,1,1,1,1,1,0,4,0,636,0
mirsantos,mirsantos,,0,12,12,0,22,22,2,0.65,0.730769,0,76,0,640,0.022727
ozirismg,ozirismg,,0,1,1,0,4,4,2,0.545455,0.583333,0,10,0,641,0
brasil61_,brasil61_,,2,3,5,2,6,8,1,1,1,0,4,0,251,0.05
GovernoMA,GovernoMA,,1,0,1,1,0,1,0,0,0,0,4,0,250,0
FlavioDino,FlavioDino,,1,0,1,1,0,1,0,0,0,0,4,0,249,0
AledeAndradeIII,AledeAndradeIII,,2,2,4,3,5,8,1,1,1,0,28,0,643,0.5
SBInfectologia,SBInfectologia,,3,0,3,5,0,5,0,0,0,0,28,0,642,0.166667
jonatasantos90,jonatasantos90,,0,1,1,0,1,1,1,1,1,0,4,0,644,0
leoheaste,leoheaste,,0,2,2,0,8,8,2,0.75,0.833333,0,8,0,645,0.5
ComelioS,ComelioS,,0,1,1,0,1,1,2,0.6,0.666667,0,31,0,646,0
ONUNews,ONUNews,,5,2,7,7,2,9,1,1,1,0,31,0,121,0.142857
neco_anastacio,neco_anastacio,,0,1,1,0,15,15,2,0.545455,0.583333,0,10,0,647,0
sigancan,sigancan,,0,1,1,0,1,1,1,1,1,0,29,0,648,0
SSalud_mx,SSalud_mx,,107,0,107,245,0,245,0,0,0,0,29,0,411,0
TVClube_,TVClube_,,1,0,1,1,0,1,0,0,0,0,1,1,439,0
angelarosane,angelarosane,,0,4,4,0,6,6,1,1,1,0,76,0,649,0.333333
Marcosboniatti,Marcosboniatti,,0,1,1,0,1,1,1,1,1,0,4,0,650,0
Dhafneh,Dhafneh,,0,2,2,0,2,2,2,0.666667,0.75,0,76,0,651,0
JMartinsFilho2,JMartinsFilho2,,0,1,1,0,2,2,3,0.413793,0.458333,0,4,0,652,0
CiprianyPatriot,CiprianyPatriot,,0,1,1,0,1,1,1,1,1,0,4,0,653,0
Luitzr,Luitzr,,0,2,2,0,2,2,1,1,1,0,4,0,654,0
manuelale69,manuelale69,,0,1,1,0,1,1,1,1,1,0,30,19,656,0
MinSaludGuate,MinSaludGuate,,1,0,1,1,0,1,0,0,0,0,30,19,655,0
BaiaRodrigues,BaiaRodrigues,,0,2,2,0,2,2,1,1,1,0,4,0,657,0
FMUSPoficial,FMUSPoficial,,2,0,2,2,0,2,0,0,0,0,4,0,321,0
MRJACKSONJOSEPH,MRJACKSONJOSEPH,,0,3,3,0,9,9,2,0.8,0.875,0,8,0,659,0.166667
RodrigoFrutuoso,RodrigoFrutuoso,,0,1,1,0,1,1,2,0.571429,0.625,0,5,0,660,0
JOrleti,JOrleti,,0,1,1,0,1,1,2,0.666667,0.75,0,76,0,661,0
StelaSalgado,StelaSalgado,,0,1,1,0,1,1,2,0.666667,0.75,0,76,0,662,0
henriquepcruz,henriquepcruz,,1,0,1,1,0,1,0,0,0,0,0,0,282,0
candidoalex,candidoalex,,0,1,1,0,1,1,1,1,1,0,25,0,663,0
wvsaborido,wvsaborido,,0,1,1,0,1,1,1,1,1,0,4,0,664,0
isabecarve,isabecarve,,0,1,1,0,1,1,2,0.6,0.666667,0,8,0,665,0
Walliiison,Walliiison,,0,1,1,0,1,1,1,1,1,0,4,0,666,0
OnSafety_app,OnSafety_app,,1,0,1,1,0,1,0,0,0,0,0,0,281,0
MarinesWitzke,MarinesWitzke,,0,3,3,0,6,6,2,0.666667,0.75,0,10,0,667,0.333333
marabianchetti,marabianchetti,,0,1,1,0,1,1,1,1,1,0,76,0,668,0
prefeiturabh,prefeiturabh,,3,0,3,3,0,3,0,0,0,0,76,0,115,0.166667
Valter63722020,Valter63722020,,0,4,4,0,4,4,1,1,1,0,38,0,673,0
BancariosIpat,BancariosIpat,,1,0,1,1,0,1,0,0,0,0,38,0,672,0
lukinhascais,lukinhascais,,0,1,1,0,1,1,2,0.666667,0.75,0,5,0,675,0
claracomvida,claracomvida,,2,1,3,2,1,3,1,1,1,0,5,0,674,0
RICARDOSALES2,RICARDOSALES2,,0,3,3,0,14,14,1,1,1,0,4,0,676,0.166667
tvbrasilgov,tvbrasilgov,,28,1,29,51,5,56,1,1,1,0,4,0,322,0.033251
Covid_19DC,Covid_19DC,,0,1,1,0,1,1,2,0.666667,0.75,0,5,0,677,0
djcruzramos74,djcruzramos74,,0,1,1,0,1,1,1,1,1,0,4,0,678,0
paisefilhos,paisefilhos,,10,0,10,10,0,10,0,0,0,0,80,0,237,0
GondimLavinia,GondimLavinia,,0,3,3,0,3,3,1,1,1,0,41,0,679,0.333333
Maurorezendepsi,Maurorezendepsi,,0,1,1,0,1,1,1,1,1,0,4,0,680,0
Grupo_DDP,Grupo_DDP,,0,2,2,0,3,3,2,0.75,0.833333,0,31,0,681,0.5
NacoesUnidas,NacoesUnidas,,22,2,24,33,5,38,1,1,1,0.000002,31,0,8,0.014493
LiliaRRS8,LiliaRRS8,,0,1,1,0,1,1,1,1,1,0,4,0,682,0
PortalMultiplix,PortalMultiplix,,2,0,2,7,0,7,0,0,0,0,0,0,280,0
sulinformacao,sulinformacao,,6,0,6,31,0,31,0,0,0,0,0,0,279,0
innnmvs,innnmvs,,0,1,1,0,4,4,1,1,1,0,29,0,683,0
ama_gov_pt,ama_gov_pt,,0,1,1,0,1,1,2,0.6,0.666667,0,8,0,684,0
aprovinciadopa,aprovinciadopa,,1,1,2,1,1,2,0,0,0,0,32,20,685,0
JosBenicioSous5,JosBenicioSous5,,0,1,1,0,1,1,1,1,1,0,4,0,686,0
nncoelho,nncoelho,,0,1,1,0,1,1,1,1,1,0,33,21,688,0
SocCardioESP,SocCardioESP,,2,0,2,2,0,2,0,0,0,0,33,21,687,0
prefechapeco,prefechapeco,,4,0,4,10,0,10,0,0,0,0,0,0,270,0
DanilloBrhaz,DanilloBrhaz,,0,1,1,0,1,1,1,1,1,0,4,0,689,0
HufnagelJunior,HufnagelJunior,,0,1,1,0,3,3,1,1,1,0,38,0,691,0
ady_news,ady_news,,18,0,18,38,0,38,0,0,0,0,38,0,690,0
educardocarlos,educardocarlos,,0,1,1,0,1,1,1,1,1,0,34,22,693,0
abraincoficial,abraincoficial,,1,0,1,1,0,1,0,0,0,0,34,22,692,0
Brasil88602987,Brasil88602987,,0,1,1,0,1,1,1,1,1,0,4,0,694,0
Brookexxsaku,Brookexxsaku,,0,1,1,0,1,1,2,0.545455,0.583333,0,10,0,695,0
carlosa20472949,carlosa20472949,,0,1,1,0,1,1,1,1,1,0,35,23,697,0
TV_Piaui,TV_Piaui,,1,0,1,1,0,1,0,0,0,0,35,23,696,0
evelozaf62,evelozaf62,,0,1,1,0,1,1,2,0.6,0.666667,0,8,0,698,0
Davi14387348,Davi14387348,,0,1,1,0,1,1,1,1,1,0,4,0,699,0
BRagronegocio,BRagronegocio,,0,1,1,0,1,1,1,1,1,0,36,24,701,0
destaquerural,destaquerural,,1,0,1,1,0,1,0,0,0,0,36,24,700,0
Srgio45860350,Srgio45860350,,0,1,1,0,1,1,1,1,1,0,4,0,702,0
JUANAARMENTA6,JUANAARMENTA6,,0,2,2,0,2,2,1,1,1,0,37,25,705,0.5
hojaderutamexic,hojaderutamexic,,2,1,3,2,1,3,1,1,1,0,37,25,704,0.333333
gobiernozac,gobiernozac,,3,0,3,3,0,3,0,0,0,0,37,25,703,0.333333
m_soldati,m_soldati,,0,1,1,0,13,13,1,1,1,0,38,0,706,0
Byna3690,Byna3690,,0,1,1,0,3,3,1,1,1,0,38,0,707,0
gersonofficiell,gersonofficiell,,2,0,2,3,0,3,0,0,0,0,0,0,269,0
quarentena_bot,quarentena_bot,,0,12,12,0,14,14,2,0.8,0.875,0,5,0,715,0.007576
AntonioFlauzin1,AntonioFlauzin1,,0,1,1,0,5,5,2,0.545455,0.583333,0,10,0,716,0
mariaspsicologa,mariaspsicologa,,0,1,1,0,1,1,1,1,1,0,4,0,717,0
AnaKaroline28,AnaKaroline28,,0,4,4,0,7,7,2,0.666667,0.75,0,10,0,718,0.25
danielguimaf,danielguimaf,,13,1,14,34,9,43,0,0,0,0,5,0,376,0.076923
diogenes_fran,diogenes_fran,,0,3,3,0,4,4,1,1,1,0,38,0,719,0
spbancarios,spbancarios,,12,0,12,15,0,15,0,0,0,0,38,0,669,0
bolsonaro2022ok,bolsonaro2022ok,,0,1,1,0,1,1,1,1,1,0,4,0,720,0
_jayninhaah,_jayninhaah,,0,1,1,0,2,2,1,1,1,0,0,0,721,0
beldeplantao,beldeplantao,,2,0,2,4,0,4,0,0,0,0,0,0,261,0
norditalia2020,norditalia2020,,0,1,1,0,1,1,1,1,1,0,39,26,723,0
meloni,meloni,,1,0,1,1,0,1,0,0,0,0,39,26,722,0
_JPGuerra,_JPGuerra,,1,2,3,1,3,4,1,1,1,0,5,0,709,0.166667
ChelseaFC,ChelseaFC,,6,0,6,7,0,7,0,0,0,0,5,0,132,0.133333
Alhilal_FC,Alhilal_FC,,1,0,1,1,0,1,0,0,0,0,5,0,708,0
Clodoal32241459,Clodoal32241459,,0,1,1,0,1,1,1,1,1,0,4,0,724,0
garimpodeacoes,garimpodeacoes,,0,1,1,0,1,1,1,1,1,0,4,0,725,0
batalhaespirit,batalhaespirit,,0,1,1,0,1,1,1,1,1,0,4,0,726,0
Cleuza2021,Cleuza2021,,0,4,4,0,5,5,3,0.479167,0.543478,0,10,0,727,0
congressoemfoco,congressoemfoco,,11,0,11,11,0,11,0,0,0,0,10,0,6,0
Francis57764581,Francis57764581,,0,1,1,0,1,1,1,1,1,0,4,0,728,0
Juanita61348092,Juanita61348092,,0,1,1,0,1,1,1,1,1,0,4,0,729,0
KnigthEverton,KnigthEverton,,0,1,1,0,1,1,1,1,1,0,4,0,730,0
Solange96370314,Solange96370314,,0,1,1,0,1,1,1,1,1,0,4,0,731,0
LinoJeova,LinoJeova,,0,1,1,0,1,1,1,1,1,0,4,0,732,0
RafaelBastian16,RafaelBastian16,,0,1,1,0,1,1,1,1,1,0,4,0,733,0
SaudeMG,SaudeMG,,6,0,6,19,0,19,0,0,0,0,0,0,212,0.066667
BrCovidBot_1,BrCovidBot_1,,4,0,4,22,0,22,0,0,0,0,0,0,268,0
edinilson_sramo,edinilson_sramo,,0,1,1,0,1,1,1,1,1,0,4,0,734,0
AguinaldoPetrin,AguinaldoPetrin,,0,1,1,0,1,1,1,1,1,0,4,0,735,0
MidiaInformal,MidiaInformal,,2,1,3,4,2,6,1,1,1,0,0,0,267,0.166667
InformeRJO,InformeRJO,,2,0,2,4,0,4,0,0,0,0,0,0,266,0.5
TrasElValle_OBC,TrasElValle_OBC,,4,2,6,21,18,39,1,1,1,0,40,0,141,0.416667
jjaranaz94,jjaranaz94,,3,2,5,19,18,37,1,1,1,0,40,0,141,0.666667
CFKlebelor,CFKlebelor,,0,1,1,0,1,1,1,1,1,0,8,0,736,0
soldierof0din,soldierof0din,,0,3,3,0,3,3,1,1,1,0,4,0,737,0.166667
MFreireB_13,MFreireB_13,,0,7,7,0,8,8,1,1,1,0,41,0,742,0.02381
VozProgressista,VozProgressista,,1,1,2,1,1,2,1,1,1,0,41,0,741,0.5
alexandrekalil,alexandrekalil,,2,0,2,2,0,2,0,0,0,0,41,0,740,0.5
raphamsenna,raphamsenna,,0,1,1,0,5,5,1,1,1,0,42,0,743,0
dieviviarruda,dieviviarruda,,0,1,1,0,4,4,2,0.545455,0.583333,0,10,0,744,0
casacivilbr,casacivilbr,,3,0,3,8,0,8,0,0,0,0,4,0,498,0
JampaRobo,JampaRobo,,0,7,7,0,19,19,2,0.705882,0.791667,0,147,0,747,0.047619
profetadorancor,profetadorancor,,0,1,1,0,28,28,2,0.545455,0.583333,0,10,0,748,0
RosiMarinato,RosiMarinato,,0,1,1,0,1,1,1,1,1,0,4,0,749,0
bre1602,bre1602,,0,1,1,0,1,1,1,1,1,0,4,0,750,0
InaraBirnfeld,InaraBirnfeld,,0,1,1,0,1,1,1,1,1,0,4,0,751,0
Dulobs1,Dulobs1,,0,2,2,0,3,3,1,1,1,0,4,0,752,0
Migpih,Migpih,,0,1,1,0,1,1,2,0.545455,0.583333,0,10,0,753,0
GEORGEP23802081,GEORGEP23802081,,0,1,1,0,1,1,1,1,1,0,4,0,754,0
Lassa62939836,Lassa62939836,,0,1,1,0,1,1,1,1,1,0,4,0,755,0
Fefa_Gouveia,Fefa_Gouveia,,0,6,6,0,20,20,3,0.495413,0.533951,0,10,0,756,0.333333
RaySouz93221370,RaySouz93221370,,0,1,1,0,1,1,1,1,1,0,4,0,757,0
goianiabot,goianiabot,,0,5,5,0,9,9,2,0.666667,0.75,0,66,0,761,0
prefeituradegyn,prefeituradegyn,,2,0,2,3,0,3,0,0,0,0,66,0,760,0
Helenic93752169,Helenic93752169,,0,1,1,0,1,1,1,1,1,0,4,0,762,0
EleitorBr73,EleitorBr73,,0,1,1,0,1,1,1,1,1,0,4,0,763,0
jccouceiro,jccouceiro,,0,1,1,0,2,2,1,1,1,0,25,0,764,0
VaLmirBR_rj,VaLmirBR_rj,,0,1,1,0,2,2,2,0.545455,0.583333,0,10,0,765,0
Joseniakk,Joseniakk,,0,1,1,0,1,1,1,1,1,0,25,0,766,0
euzasp,euzasp,,0,1,1,0,1,1,1,1,1,0,25,0,767,0
MariaBo36810267,MariaBo36810267,,0,1,1,0,1,1,1,1,1,0,25,0,768,0
farmacialgarve,farmacialgarve,,0,1,1,0,1,1,1,1,1,0,8,0,769,0
SylviaMinion3,SylviaMinion3,,0,1,1,0,2,2,1,1,1,0,25,0,770,0
cassionseabra,cassionseabra,,0,1,1,0,1,1,1,1,1,0,4,0,771,0
CardosoZL,CardosoZL,,0,1,1,0,1,1,1,1,1,0,4,0,772,0
Joclau53,Joclau53,,0,1,1,0,1,1,1,1,1,0,41,0,773,0
wedduarda,wedduarda,,0,1,1,0,1,1,1,1,1,0,19,0,774,0
flaviofachel,flaviofachel,,117,0,117,139,0,139,0,0,0,0,19,0,136,0.000074
christa_wanke,christa_wanke,,0,3,3,0,5,5,2,0.714286,0.8,0,76,0,775,0
Edison388,Edison388,,0,1,1,0,1,1,1,1,1,0,4,0,776,0
MSR781,MSR781,,0,1,1,0,1,1,1,1,1,0,4,0,777,0
marcus_vasc,marcus_vasc,,0,2,2,0,2,2,3,0.428571,0.518519,0,76,0,778,0
covid19_cnpq,covid19_cnpq,,7,1,8,7,1,8,2,0.545455,0.583333,0,10,0,184,0.107143
hbrumjunior,hbrumjunior,,0,1,1,0,1,1,1,1,1,0,4,0,779,0
Neile26692034,Neile26692034,,0,1,1,0,1,1,1,1,1,0,4,0,780,0
dvdnasc,dvdnasc,,0,1,1,0,1,1,1,1,1,0,4,0,781,0
Agespisa,Agespisa,,1,0,1,1,0,1,0,0,0,0,0,0,265,0
Hussardo2022,Hussardo2022,,0,1,1,0,1,1,1,1,1,0,4,0,782,0
LinhasdeElvas,LinhasdeElvas,,1,0,1,17,0,17,0,0,0,0,0,0,264,0
LaurianyGeize,LaurianyGeize,,1,0,1,1,0,1,0,0,0,0,10,0,414,0
Contareservatmj,Contareservatmj,,0,1,1,0,1,1,1,1,1,0,4,0,783,0
AntonioSeixasD2,AntonioSeixasD2,,0,1,1,0,1,1,1,1,1,0,4,0,784,0
clovisinacio,clovisinacio,,0,1,1,0,1,1,1,1,1,0,4,0,785,0
HiperEpi,HiperEpi,,1,0,1,5,0,5,0,0,0,0,0,0,263,0
artista_Fran,artista_Fran,,0,2,2,0,8,8,2,0.583333,0.642857,0,10,0,786,0
IGASaude,IGASaude,,0,2,2,0,2,2,2,0.666667,0.75,0,8,0,787,0
Suelisouza2001,Suelisouza2001,,0,2,2,0,3,3,1,1,1,0,4,0,788,0
leandro37503589,leandro37503589,,1,1,2,1,1,2,0,0,0,0,44,27,789,0
FranciscoMalosa,FranciscoMalosa,,0,8,8,0,11,11,2,0.681818,0.766667,0,31,0,790,0.178571
portal_viva,portal_viva,,4,0,4,7,0,7,0,0,0,0,0,0,262,0.083333
ThiagoC93001399,ThiagoC93001399,,0,3,3,0,16,16,2,0.615385,0.6875,0,10,0,791,0
WagnerRPugliese,WagnerRPugliese,,0,1,1,0,1,1,1,1,1,0,4,0,792,0
BetoMoes,BetoMoes,,0,1,1,0,1,1,1,1,1,0,10,0,793,0
Metropoles,Metropoles,,49,0,49,50,0,50,0,0,0,0,10,0,10,0.028912
Edson85240231,Edson85240231,,0,1,1,0,1,1,1,1,1,0,4,0,794,0
NoangelaN,NoangelaN,,0,1,1,0,1,1,1,1,1,0,8,0,795,0
CarlosA76979782,CarlosA76979782,,0,2,2,0,3,3,1,1,1,0,25,0,796,0
taureis_,taureis_,,0,1,1,0,1,1,1,1,1,0,4,0,797,0
CarvalhalKarla,CarvalhalKarla,,0,2,2,0,3,3,2,0.75,0.833333,0,31,0,798,0.5
Arcamargo70,Arcamargo70,,0,1,1,0,1,1,1,1,1,0,4,0,799,0
mmarcosfernande,mmarcosfernande,,0,2,2,0,2,2,1,1,1,0,125,0,800,0.5
Arthurvneto,Arthurvneto,,167,1,168,169,1,170,1,1,1,0,125,0,371,0.005988
DIOVALJUNIOR,DIOVALJUNIOR,,0,1,1,0,1,1,1,1,1,0,4,0,801,0
SamuelR36011855,SamuelR36011855,,0,1,1,0,1,1,1,1,1,0,4,0,802,0
Marciof03019030,Marciof03019030,,0,2,2,0,2,2,1,1,1,0,4,0,803,0
danielsoranz,danielsoranz,,3,1,4,4,1,5,1,1,1,0.000002,27,0,82,0.166667
Tareco_G,Tareco_G,,0,1,1,0,8,8,1,1,1,0,45,0,804,0
ONUPortugal,ONUPortugal,,0,1,1,0,1,1,1,1,1,0,31,0,806,0
UNDP,UNDP,,2,0,2,2,0,2,0,0,0,0,31,0,805,0
vitoriasam01,vitoriasam01,,0,1,1,0,1,1,1,1,1,0,4,0,807,0
PEC32_NAO,PEC32_NAO,,0,1,1,0,1,1,2,0.545455,0.583333,0,10,0,808,0
giorgio_renan,giorgio_renan,,0,1,1,0,1,1,1,1,1,0,4,0,809,0
Bruno78062135,Bruno78062135,,0,1,1,0,1,1,1,1,1,0,4,0,810,0
MulheresEmFoco,MulheresEmFoco,,0,1,1,0,1,1,1,1,1,0,46,0,812,0
CNNBrasil,CNNBrasil,,4,0,4,4,0,4,0,0,0,0,46,0,811,0
P_Eduardo_Silva,P_Eduardo_Silva,,0,1,1,0,1,1,2,0.545455,0.583333,0,10,0,813,0
Coronel_Mills,Coronel_Mills,,0,1,1,0,1,1,1,1,1,0,4,0,814,0
roupasdesaojor1,roupasdesaojor1,,0,2,2,0,2,2,1,1,1,0,4,0,815,0
WHO,WHO,,6,0,6,10,0,10,0,0,0,0,31,0,0,0.066667
claupace,claupace,,0,2,2,0,2,2,1,1,1,0,4,0,816,0
9deazevedo,9deazevedo,,0,2,2,0,2,2,2,0.583333,0.642857,0,41,0,817,0
AncarluKul,AncarluKul,,0,1,1,0,1,1,1,1,1,0,4,0,818,0
Mercb5,Mercb5,,0,1,1,0,1,1,1,1,1,0,47,28,820,0
RJTranslator,RJTranslator,,2,0,2,2,0,2,0,0,0,0,47,28,819,0
SrJorgeSantana,SrJorgeSantana,,0,1,1,0,1,1,2,0.545455,0.583333,0,10,0,821,0
dudus09,dudus09,,0,1,1,0,1,1,2,0.545455,0.583333,0,10,0,822,0
naoeramaisfacil,naoeramaisfacil,,0,2,2,0,3,3,1,1,1,0,48,29,825,0
SICNoticias,SICNoticias,,1,0,1,2,0,2,0,0,0,0,48,29,824,0
PedroSergioRib4,PedroSergioRib4,,0,1,1,0,1,1,1,1,1,0,4,0,826,0
RobertSzymansky,RobertSzymansky,,0,1,1,0,1,1,1,1,1,0,4,0,827,0
stefanovilarim,stefanovilarim,,0,1,1,0,1,1,1,1,1,0,4,0,828,0
Claudia99723212,Claudia99723212,,0,1,1,0,1,1,1,1,1,0,4,0,829,0
MARCIOTICOS,MARCIOTICOS,,0,1,1,0,1,1,1,1,1,0,4,0,830,0
sommelier50,sommelier50,,0,1,1,0,1,1,1,1,1,0,41,0,831,0
LuanaPa76021782,LuanaPa76021782,,0,1,1,0,1,1,1,1,1,0,4,0,832,0
AndreTomaz16,AndreTomaz16,,0,1,1,0,1,1,1,1,1,0,4,0,833,0
duporteiro17,duporteiro17,,0,1,1,0,1,1,1,1,1,0,4,0,834,0
merchigan,merchigan,,0,1,1,0,1,1,2,0.6,0.666667,0,8,0,835,0
Vitoria50901012,Vitoria50901012,,0,1,1,0,1,1,1,1,1,0,4,0,836,0
Nimalima1,Nimalima1,,0,1,1,0,1,1,1,1,1,0,49,30,838,0
elishbajoachim,elishbajoachim,,2,0,2,2,0,2,0,0,0,0,49,30,837,0
macsanto787,macsanto787,,0,2,2,0,2,2,2,0.583333,0.642857,0,10,0,839,0
patativaparana,patativaparana,,0,1,1,0,1,1,2,0.545455,0.583333,0,10,0,840,0
GalhanoHugo,GalhanoHugo,,1,1,2,1,1,2,2,0.571429,0.625,0,5,0,260,0.5
Morghana_Kelly,Morghana_Kelly,,0,1,1,0,1,1,1,1,1,0,25,0,841,0
Samodan,Samodan,,0,1,1,0,1,1,1,1,1,0,4,0,842,0
NiviaFx,NiviaFx,,0,2,2,0,5,5,2,0.583333,0.642857,0,10,0,843,0
IsaacOliveira57,IsaacOliveira57,,0,1,1,0,2,2,1,1,1,0,25,0,844,0
simonerrodrigue,simonerrodrigue,,0,1,1,0,1,1,1,1,1,0,19,0,845,0
Utopia_2020,Utopia_2020,,0,2,2,0,4,4,2,0.5625,0.611111,0,10,0,846,0
mariofalcao,mariofalcao,,0,1,1,0,1,1,1,1,1,0,41,0,847,0
EberOliveiraUdi,EberOliveiraUdi,,0,1,1,0,1,1,1,1,1,0,4,0,848,0
catadinha,catadinha,,0,1,1,0,1,1,1,1,1,0,4,0,849,0
FabimBrasil,FabimBrasil,,0,2,2,0,2,2,1,1,1,0,4,0,850,0
alimeduc,alimeduc,,0,1,1,0,1,1,1,1,1,0,41,0,851,0
MishelleTapia3,MishelleTapia3,,0,1,1,0,4,4,1,1,1,0,29,0,852,0
uniaonet,uniaonet,,2,0,2,4,0,4,0,0,0,0,0,0,252,0
themrosal,themrosal,,2,0,2,3,0,3,0,0,0,0,0,0,259,0
Thiagovieira_RJ,Thiagovieira_RJ,,0,1,1,0,1,1,2,0.545455,0.583333,0,10,0,853,0
quandogiromundo,quandogiromundo,,0,1,1,0,1,1,1,1,1,0,4,0,854,0
Tweetando12,Tweetando12,,0,2,2,0,2,2,2,0.583333,0.642857,0,19,0,855,0
JorgeGoche1,JorgeGoche1,,0,1,1,0,1,1,1,1,1,0,4,0,856,0
Politic_Nicki,Politic_Nicki,,0,1,1,0,1,1,2,0.545455,0.583333,0,10,0,857,0
Igualdadejusti1,Igualdadejusti1,,0,3,3,0,21,21,2,0.666667,0.75,0,10,0,858,0.666667
samnmx,samnmx,,0,1,1,0,8,8,1,1,1,0,29,0,859,0
Emlio36605051,Emlio36605051,,0,1,1,0,1,1,1,1,1,0,4,0,860,0
exclusivoluiz,exclusivoluiz,,0,1,1,0,1,1,1,1,1,0,4,0,861,0
unicampbot,unicampbot,,0,5,5,0,5,5,3,0.490741,0.525157,0,27,0,862,0.5
DantedeVerdade,DantedeVerdade,,0,1,1,0,1,1,1,1,1,0,50,0,863,0
rosedbarros,rosedbarros,,19,1,20,21,2,23,0,0,0,0,50,0,574,0.052632
inspiredpunk,inspiredpunk,,0,1,1,0,1,1,1,1,1,0,41,0,864,0
mafra_leoni,mafra_leoni,,0,1,1,0,1,1,1,1,1,0,51,31,866,0
PhabioSales,PhabioSales,,1,0,1,1,0,1,0,0,0,0,51,31,865,0
citadoaleatorio,citadoaleatorio,,0,2,2,0,2,2,1,1,1,0,52,0,869,0.5
Glauquete,Glauquete,,5,1,6,5,1,6,1,1,1,0,52,0,868,0.166667
cauemoura,cauemoura,,6,0,6,6,0,6,0,0,0,0,52,0,867,0.166667
ROwoltada,ROwoltada,,0,1,1,0,1,1,2,0.545455,0.583333,0,10,0,870,0
jcanongia,jcanongia,,0,1,1,0,1,1,1,1,1,0,4,0,871,0
gerardo_caldera,gerardo_caldera,,0,1,1,0,1,1,1,1,1,0,71,0,872,0
RadioRedencao,RadioRedencao,,7,0,7,10,0,10,0,0,0,0,71,0,350,0
gersonsflores,gersonsflores,,0,2,2,0,2,2,1,1,1,0,4,0,873,0
wilsonmessias01,wilsonmessias01,,0,2,2,0,2,2,1,1,1,0,73,0,874,0
SSalud_Qro,SSalud_Qro,,0,1,1,0,5,5,1,1,1,0,29,0,875,0
Mahori4,Mahori4,,0,1,1,0,3,3,1,1,1,0,29,0,876,0
BerettaK9T,BerettaK9T,,0,1,1,0,1,1,1,1,1,0,4,0,877,0
marcoslmsantana,marcoslmsantana,,0,1,1,0,1,1,1,1,1,0,4,0,878,0
SandyPandy_Oh_,SandyPandy_Oh_,,0,1,1,0,9,9,1,1,1,0,29,0,879,0
veracru41394141,veracru41394141,,0,1,1,0,1,1,1,1,1,0,4,0,880,0
jlaalmeidajr,jlaalmeidajr,,0,1,1,0,1,1,1,1,1,0,4,0,881,0
Emersonm72,Emersonm72,,0,1,1,0,1,1,1,1,1,0,53,32,883,0
JornalDaGlobo,JornalDaGlobo,,1,0,1,1,0,1,0,0,0,0,53,32,882,0
bylutete,bylutete,,0,1,1,0,1,1,2,0.545455,0.583333,0,10,0,884,0
JFlorenciok,JFlorenciok,,0,1,1,0,1,1,1,1,1,0,4,0,885,0
EltonCa20982408,EltonCa20982408,,0,1,1,0,1,1,1,1,1,0,41,0,886,0
JLuizEsteves,JLuizEsteves,,0,2,2,0,7,7,1,1,1,0,4,0,887,0
Hugocostalima1,Hugocostalima1,,0,1,1,0,1,1,1,1,1,0,4,0,888,0
JooCarl48702308,JooCarl48702308,,0,1,1,0,1,1,1,1,1,0,41,0,889,0
marcos_almeida,marcos_almeida,,0,1,1,0,1,1,1,1,1,0,41,0,890,0
gtfilho,gtfilho,,0,1,1,0,2,2,1,1,1,0,4,0,891,0
Moacyrodrigues,Moacyrodrigues,,0,1,1,0,2,2,1,1,1,0,25,0,892,0
FabioJFS,FabioJFS,,0,1,1,0,1,1,1,1,1,0,4,0,893,0
ajuix,ajuix,,0,1,1,0,1,1,1,1,1,0,29,0,894,0
Krukke_krukke,Krukke_krukke,,0,4,4,0,5,5,2,0.642857,0.722222,0,10,0,895,0
enzogfl_,enzogfl_,,0,1,1,0,1,1,2,0.545455,0.583333,0,10,0,896,0
JardimGaudio,JardimGaudio,,0,1,1,0,1,1,1,1,1,0,41,0,897,0
valente70x7,valente70x7,,0,1,1,0,1,1,1,1,1,0,4,0,898,0
BaremLeite,BaremLeite,,0,1,1,0,1,1,1,1,1,0,54,33,900,0
hospitalalemao,hospitalalemao,,1,0,1,1,0,1,0,0,0,0,54,33,899,0
ceara59,ceara59,,0,2,2,0,2,2,1,1,1,0,55,0,902,0
RaphaelGerard17,RaphaelGerard17,,1,0,1,1,0,1,0,0,0,0,55,0,901,0
messiaswm,messiaswm,,0,1,1,0,4,4,2,0.545455,0.583333,0,10,0,903,0
gayLulista13,gayLulista13,,0,8,8,0,24,24,2,0.7,0.785714,0,10,0,904,0.035714
NoticierosRG,NoticierosRG,,0,1,1,0,9,9,1,1,1,0,29,0,905,0
Easyoil_Br,Easyoil_Br,,0,1,1,0,1,1,1,1,1,0,4,0,906,0
AlejandroMS_73,AlejandroMS_73,,0,1,1,0,1,1,1,1,1,0,0,0,907,0
latinus_us,latinus_us,,11,0,11,11,0,11,0,0,0,0,0,0,182,0
Alosiosilva2,Alosiosilva2,,0,1,1,0,1,1,1,1,1,0,4,0,908,0
idnahon,idnahon,,0,2,2,0,4,4,1,1,1,0,4,0,909,0
FelizsouMengao,FelizsouMengao,,0,1,1,0,1,1,1,1,1,0,4,0,910,0
JulianoKaiowa,JulianoKaiowa,,0,1,1,0,1,1,1,1,1,0,41,0,911,0
wzniak,wzniak,,0,1,1,0,1,1,1,1,1,0,41,0,912,0
Ca_bio01,Ca_bio01,,0,1,1,0,1,1,1,1,1,0,41,0,913,0
zaip,zaip,,0,1,1,0,2,2,1,1,1,0,41,0,914,0
olivarefabi,olivarefabi,,0,1,1,0,1,1,1,1,1,0,41,0,915,0
JosCost00443299,JosCost00443299,,0,2,2,0,3,3,1,1,1,0,4,0,916,0
Sandgon,Sandgon,,0,2,2,0,2,2,1,1,1,0,52,0,917,0.5
chaar_marcos,chaar_marcos,,0,4,4,0,4,4,3,0.56,0.630952,0,4,0,918,0.166667
alexsandraponce,alexsandraponce,,0,1,1,0,1,1,1,1,1,0,38,0,919,0
carbonarios,carbonarios,,0,2,2,0,2,2,1,1,1,0,52,0,920,0.5
Douglas86736732,Douglas86736732,,0,2,2,0,2,2,1,1,1,0,52,0,921,0.5
correiodeminas,correiodeminas,,1,0,1,8,0,8,0,0,0,0,0,0,258,0
PedroHallal,PedroHallal,,3,0,3,4,0,4,0,0,0,0,27,0,95,0.333333
JoyHarmony7,JoyHarmony7,,0,2,2,0,2,2,4,0.449153,0.477987,0,27,0,922,0.5
penabuco,penabuco,,0,1,1,0,1,1,1,1,1,0,41,0,923,0
AdelFernando2,AdelFernando2,,0,1,1,0,1,1,1,1,1,0,4,0,924,0
yamaokaro,yamaokaro,,0,1,1,0,3,3,1,1,1,0,4,0,925,0
ElianeMTardin,ElianeMTardin,,0,3,3,0,3,3,1,1,1,0,41,0,926,0
AristidesAlmei7,AristidesAlmei7,,0,1,1,0,1,1,1,1,1,0,4,0,927,0
Robsonetlima,Robsonetlima,,0,1,1,0,1,1,1,1,1,0,41,0,928,0
Beleza1965Pura,Beleza1965Pura,,0,3,3,0,3,3,1,1,1,0,41,0,930,0
HRitaReis1,HRitaReis1,,0,1,1,0,1,1,2,0.545455,0.583333,0,10,0,931,0
efernandino,efernandino,,0,1,1,0,1,1,1,1,1,0,41,0,932,0
JFH84343564,JFH84343564,,0,2,2,0,2,2,1,1,1,0,4,0,933,0
RainaCosta,RainaCosta,,0,1,1,0,1,1,1,1,1,0,41,0,934,0
Paramahansa2,Paramahansa2,,0,1,1,0,10,10,2,0.545455,0.583333,0,10,0,935,0
marcelodmartins,marcelodmartins,,0,1,1,0,1,1,1,1,1,0,4,0,936,0
TercioEliphas,TercioEliphas,,0,3,3,0,4,4,2,0.615385,0.6875,0,10,0,937,0.333333
LasLins6,LasLins6,,0,1,1,0,2,2,1,1,1,0,4,0,938,0
JulioPezR,JulioPezR,,0,1,1,0,10,10,1,1,1,0,29,0,939,0
lucineianiro57,lucineianiro57,,0,1,1,0,2,2,1,1,1,0,4,0,940,0
Vagner_Carvalh0,Vagner_Carvalh0,,0,1,1,0,1,1,1,1,1,0,4,0,941,0
silvrib,silvrib,,0,5,5,0,9,9,2,0.666667,0.75,0,10,0,943,0
reginargaa,reginargaa,,0,1,1,0,1,1,1,1,1,0,4,0,944,0
MarlonApareci10,MarlonApareci10,,0,1,1,0,4,4,1,1,1,0,5,0,945,0
covid19_faperj,covid19_faperj,,0,2,2,0,2,2,2,0.583333,0.642857,0,10,0,946,0.5
markinho1970,markinho1970,,0,1,1,0,1,1,1,1,1,0,4,0,947,0
AirtonMarceloS1,AirtonMarceloS1,,0,1,1,0,1,1,1,1,1,0,4,0,948,0
LBSC_UFRJ,LBSC_UFRJ,,0,2,2,0,3,3,2,0.583333,0.642857,0,10,0,949,0.5
JssicaS47289164,JssicaS47289164,,0,1,1,0,1,1,1,1,1,0,4,0,950,0
mariacunha45,mariacunha45,,0,1,1,0,1,1,1,1,1,0,4,0,951,0
CONAMED_SALUD,CONAMED_SALUD,,0,1,1,0,7,7,1,1,1,0,29,0,952,0
lip_ufrj,lip_ufrj,,3,2,5,5,2,7,2,0.583333,0.642857,0.000001,0,0,185,0.1
noesalvador,noesalvador,,0,1,1,0,1,1,1,1,1,0,29,0,953,0
SimoneV22035445,SimoneV22035445,,0,1,1,0,1,1,1,1,1,0,4,0,954,0
MirianEriceira,MirianEriceira,,0,1,1,0,1,1,1,1,1,0,4,0,955,0
drdavidcanto,drdavidcanto,,0,3,3,0,3,3,1,1,1,0,56,34,959,0
AngelBoligan,AngelBoligan,,2,0,2,2,0,2,0,0,0,0,56,34,958,0
El_Universal_Mx,El_Universal_Mx,,2,0,2,2,0,2,0,0,0,0,56,34,957,0
Univ_Opinion,Univ_Opinion,,2,0,2,2,0,2,0,0,0,0,56,34,956,0
nyatche,nyatche,,0,1,1,0,3,3,2,0.545455,0.583333,0,10,0,960,0
frodosincero,frodosincero,,0,1,1,0,2,2,2,0.545455,0.583333,0,10,0,961,0
CarlosSD1218,CarlosSD1218,,0,1,1,0,1,1,1,1,1,0,4,0,962,0
fpamplonar,fpamplonar,,0,1,1,0,1,1,1,1,1,0,29,0,963,0
eduardochino94,eduardochino94,,0,1,1,0,6,6,1,1,1,0,29,0,964,0
Antonio08305021,Antonio08305021,,0,1,1,0,9,9,2,0.545455,0.583333,0,10,0,965,0
DGEMexico,DGEMexico,,0,1,1,0,4,4,1,1,1,0,29,0,966,0
AndraBrito12,AndraBrito12,,0,1,1,0,1,1,1,1,1,0,4,0,967,0
Junior10297390,Junior10297390,,0,1,1,0,1,1,1,1,1,0,4,0,968,0
Francisqueado,Francisqueado,,0,1,1,0,1,1,1,1,1,0,25,0,969,0
JosRica98733548,JosRica98733548,,0,1,1,0,1,1,1,1,1,0,4,0,970,0
PBPSALUD,PBPSALUD,,0,1,1,0,2,2,1,1,1,0,29,0,971,0
JorgeMachadoGa1,JorgeMachadoGa1,,0,1,1,0,1,1,2,0.526316,0.55,0,57,0,972,0
RosaizumiRosa,RosaizumiRosa,,10,9,19,10,17,27,1,1,1,0.000004,57,0,409,0.005848
elogd,elogd,,0,1,1,0,9,9,1,1,1,0,29,0,973,0
gob_1971,gob_1971,,0,1,1,0,1,1,1,1,1,0,4,0,974,0
GacheMarcos,GacheMarcos,,0,2,2,0,3,3,1,1,1,0,50,0,976,0
MarciaGerhardt1,MarciaGerhardt1,,4,0,4,5,0,5,0,0,0,0,50,0,975,0
Rodrigo28520007,Rodrigo28520007,,0,1,1,0,9,9,1,1,1,0,29,0,977,0
cristianocalhas,cristianocalhas,,0,1,1,0,1,1,1,1,1,0,4,0,978,0
Melquisedequex,Melquisedequex,,0,1,1,0,1,1,1,1,1,0,4,0,979,0
JuarezBorges62,JuarezBorges62,,0,4,4,0,5,5,3,0.565217,0.641026,0,4,0,980,0.25
BrasilConserva5,BrasilConserva5,,0,1,1,0,1,1,1,1,1,0,4,0,981,0
aspasia_maria,aspasia_maria,,0,2,2,0,2,2,1,1,1,0,4,0,982,0
RodZacar,RodZacar,,0,1,1,0,1,1,1,1,1,0,4,0,983,0
AghilasBR,AghilasBR,,0,1,1,0,1,1,1,1,1,0,58,0,984,0
NoticiaeGuerra,NoticiaeGuerra,,16,0,16,16,0,16,0,0,0,0,58,0,942,0
joserey1506,joserey1506,,0,1,1,0,1,1,1,1,1,0,25,0,985,0
NM47309289,NM47309289,,0,1,1,0,1,1,1,1,1,0,4,0,986,0
edramx,edramx,,0,1,1,0,8,8,1,1,1,0,29,0,987,0
GuaracyMaia,GuaracyMaia,,0,1,1,0,1,1,1,1,1,0,4,0,988,0
katiaoramos,katiaoramos,,0,1,1,0,1,1,1,1,1,0,4,0,989,0
MarceloTimote12,MarceloTimote12,,0,2,2,0,5,5,1,1,1,0,4,0,990,0
pacorrocanijo,pacorrocanijo,,0,1,1,0,4,4,1,1,1,0,29,0,991,0
zfabrogmailcom,zfabrogmailcom,,0,1,1,0,1,1,1,1,1,0,4,0,992,0
ngelElPalomino1,ngelElPalomino1,,0,1,1,0,4,4,1,1,1,0,29,0,993,0
Salud_Hidalgo,Salud_Hidalgo,,0,1,1,0,9,9,1,1,1,0,29,0,994,0
oproprioeli,oproprioeli,,0,1,1,0,1,1,1,1,1,0,25,0,995,0
astridsarmento,astridsarmento,,0,1,1,0,1,1,2,0.571429,0.625,0,5,0,996,0
Antonio57686824,Antonio57686824,,0,2,2,0,2,2,1,1,1,0,4,0,997,0
AllbertAllbert,AllbertAllbert,,0,1,1,0,1,1,1,1,1,0,4,0,998,0
narayanann_m,narayanann_m,,0,1,1,0,1,1,1,1,1,0,29,0,999,0
GadoConservador,GadoConservador,,0,1,1,0,1,1,1,1,1,0,4,0,1000,0
MichellMontser5,MichellMontser5,,0,1,1,0,2,2,1,1,1,0,29,0,1001,0
sisifomx_,sisifomx_,,0,1,1,0,1,1,1,1,1,0,29,0,1002,0
GrajedaOlivas,GrajedaOlivas,,0,1,1,0,7,7,1,1,1,0,29,0,1003,0
brasil010122,brasil010122,,0,1,1,0,1,1,1,1,1,0,4,0,1004,0
1921_cruzeirao,1921_cruzeirao,,1,0,1,1,0,1,0,0,0,0,14,10,527,0
martisfermon,martisfermon,,0,1,1,0,1,1,1,1,1,0,29,0,1005,0
ITANDEHUI1801,ITANDEHUI1801,,0,1,1,0,1,1,1,1,1,0,29,0,1006,0
Duzolina1,Duzolina1,,0,1,1,0,1,1,1,1,1,0,47,28,1007,0
eziodantas,eziodantas,,0,1,1,0,5,5,2,0.545455,0.583333,0,10,0,1008,0
JooMarq22638634,JooMarq22638634,,0,1,1,0,1,1,1,1,1,0,4,0,1009,0
campa_61,campa_61,,0,1,1,0,4,4,1,1,1,0,29,0,1010,0
JosFerr04554029,JosFerr04554029,,0,1,1,0,2,2,1,1,1,0,4,0,1011,0
PatriaAmadaBr3,PatriaAmadaBr3,,0,1,1,0,1,1,1,1,1,0,4,0,1012,0
joaoteixeira578,joaoteixeira578,,0,1,1,0,1,1,1,1,1,0,4,0,1013,0
HolofoteD,HolofoteD,,1,0,1,6,0,6,0,0,0,0,0,0,257,0
rosasena,rosasena,,0,1,1,0,2,2,2,0.545455,0.583333,0,10,0,1014,0
joseoli10128861,joseoli10128861,,0,1,1,0,1,1,1,1,1,0,4,0,1015,0
RedeTaxi,RedeTaxi,,0,1,1,0,9,9,1,1,1,0,59,35,1017,0
TaxiAlphaville,TaxiAlphaville,,1,0,1,9,0,9,0,0,0,0,59,35,1016,0
Edilanebornh,Edilanebornh,,0,1,1,0,2,2,1,1,1,0,4,0,1018,0
PaganiBibi,PaganiBibi,,0,1,1,0,2,2,1,1,1,0,4,0,1019,0
DeJoacelio,DeJoacelio,,0,1,1,0,1,1,1,1,1,0,4,0,1020,0
Samuel66184888,Samuel66184888,,0,5,5,0,8,8,4,0.477477,0.518868,0,27,0,1021,0.2
MariannaLokinha,MariannaLokinha,,0,1,1,0,1,1,1,1,1,0,10,0,1022,0
g1,g1,,70,0,70,82,0,82,0,0,0,0,10,0,11,0.006625
Reginaldo8ou80,Reginaldo8ou80,,0,1,1,0,1,1,1,1,1,0,4,0,1023,0
LGLourencetti,LGLourencetti,,0,1,1,0,2,2,1,1,1,0,25,0,1024,0
DanielGdeS1984,DanielGdeS1984,,0,1,1,0,1,1,1,1,1,0,10,0,1025,0
lopesgenevaldo1,lopesgenevaldo1,,0,1,1,0,2,2,1,1,1,0,25,0,1026,0
PeloiMaycon,PeloiMaycon,,0,1,1,0,1,1,1,1,1,0,4,0,1027,0
Alexvieyra1,Alexvieyra1,,0,1,1,0,1,1,1,1,1,0,0,0,1028,0
rodrigopmedina,rodrigopmedina,,0,1,1,0,2,2,1,1,1,0,25,0,1029,0
nutrisuelen_,nutrisuelen_,,0,1,1,0,1,1,2,0.545455,0.583333,0,10,0,1030,0
nanyshidou,nanyshidou,,0,1,1,0,1,1,1,1,1,0,10,0,1031,0
PatriaPtria1,PatriaPtria1,,0,1,1,0,1,1,1,1,1,0,4,0,1032,0
AnicetoDjalma,AnicetoDjalma,,0,1,1,0,1,1,1,1,1,0,4,0,1033,0
RahWalker_,RahWalker_,,0,1,1,0,2,2,1,1,1,0,10,0,1034,0
IngraBilly,IngraBilly,,0,1,1,0,1,1,1,1,1,0,4,0,1035,0
tonyreis_tr1,tonyreis_tr1,,0,1,1,0,2,2,1,1,1,0,4,0,1036,0
KleberMelo17,KleberMelo17,,0,1,1,0,1,1,1,1,1,0,4,0,1037,0
kiririkyu,kiririkyu,,0,1,1,0,1,1,2,0.545455,0.583333,0,10,0,1038,0
roatanasio,roatanasio,,0,1,1,0,1,1,2,0.545455,0.583333,0,10,0,1039,0
ElcyPereira9,ElcyPereira9,,0,1,1,0,2,2,1,1,1,0,4,0,1040,0
cantodeunha,cantodeunha,,0,1,1,0,1,1,1,1,1,0,62,0,1041,0
fa_anargomes,fa_anargomes,,0,1,1,0,2,2,2,0.545455,0.583333,0,10,0,1042,0
leudemi,leudemi,,0,1,1,0,1,1,1,1,1,0,60,36,1044,0
divulgueibr,divulgueibr,,1,0,1,1,0,1,0,0,0,0,60,36,1043,0
Crof,Crof,,0,1,1,0,4,4,1,1,1,0,61,37,1046,0
covidbrasilbot,covidbrasilbot,,2,0,2,5,0,5,0,0,0,0,61,37,1045,0
JulioEduardo26,JulioEduardo26,,0,2,2,0,2,2,2,0.666667,0.75,0,62,0,1047,0
CDCgov,CDCgov,,68,0,68,84,0,84,0,0,0,0,62,0,135,0
EuMelky,EuMelky,,0,2,2,0,2,2,2,0.666667,0.75,0,62,0,1048,0
EdoardoMath,EdoardoMath,,0,1,1,0,1,1,1,1,1,0,29,0,1049,0
eli_jmor,eli_jmor,,0,1,1,0,2,2,1,1,1,0,29,0,1050,0
Tati902224,Tati902224,,0,1,1,0,2,2,2,0.545455,0.583333,0,10,0,1051,0
rafa_kenji,rafa_kenji,,0,1,1,0,1,1,1,1,1,0,76,0,1052,0
ONUBrasil,ONUBrasil,,37,0,37,42,0,42,0,0,0,0,76,0,337,0
MdgAbe,MdgAbe,,0,1,1,0,7,7,1,1,1,0,29,0,1053,0
elisfilho1411,elisfilho1411,,0,2,2,0,24,24,2,0.6,0.666667,0,10,0,1054,0.5
AdsumP,AdsumP,,0,2,2,0,5,5,2,0.666667,0.75,0,62,0,1055,0
by_Faby,by_Faby,,0,1,1,0,1,1,2,0.545455,0.583333,0,10,0,1056,0
Marce8Rodriguez,Marce8Rodriguez,,0,1,1,0,2,2,1,1,1,0,29,0,1057,0
TatiAnaSG1,TatiAnaSG1,,0,3,3,0,4,4,2,0.636364,0.714286,0,10,0,1058,0.166667
GuedesGrasielle,GuedesGrasielle,,0,1,1,0,1,1,1,1,1,0,5,0,1059,0
SaudeGovRJ,SaudeGovRJ,,23,0,23,24,0,24,0,0,0,0,5,0,137,0.011858
dimerstt,dimerstt,,0,1,1,0,4,4,2,0.545455,0.583333,0,10,0,1060,0
COVID19BrUpdate,COVID19BrUpdate,,2,0,2,3,0,3,0,0,0,0,10,0,410,0
MarceloUchoa9,MarceloUchoa9,,0,2,2,0,2,2,2,0.666667,0.75,0,62,0,1061,0
ALavandula,ALavandula,,0,1,1,0,12,12,1,1,1,0,88,0,1062,0
Jeffwin72095858,Jeffwin72095858,,0,2,2,0,2,2,1,1,1,0,38,0,1063,0
rafadonadone,rafadonadone,,0,2,2,0,5,5,2,0.6,0.666667,0,10,0,1064,0.5
Leonardo_tsouza,Leonardo_tsouza,,0,1,1,0,2,2,2,0.545455,0.583333,0,10,0,1065,0
ikrishy,ikrishy,,0,1,1,0,2,2,1,1,1,0,29,0,1066,0
natilopes98,natilopes98,,0,1,1,0,1,1,1,1,1,0,5,0,1067,0
NildaMelito,NildaMelito,,0,2,2,0,2,2,1,1,1,0,125,0,1068,0.5
ManilkaraZ,ManilkaraZ,,0,1,1,0,2,2,1,1,1,0,29,0,1069,0
marcellasrb,marcellasrb,,0,1,1,0,3,3,2,0.545455,0.583333,0,10,0,1070,0
Saulinha1,Saulinha1,,0,1,1,0,1,1,1,1,1,0,4,0,1071,0
VICTORJ29783730,VICTORJ29783730,,0,1,1,0,6,6,1,1,1,0,29,0,1072,0
Issa_jp_angel,Issa_jp_angel,,0,1,1,0,1,1,1,1,1,0,4,0,1073,0
terrivelovelha,terrivelovelha,,0,2,2,0,2,2,2,0.666667,0.75,0,62,0,1074,0
Noem48,Noem48,,0,1,1,0,2,2,1,1,1,0,29,0,1075,0
bcrment,bcrment,,0,2,2,0,2,2,2,0.666667,0.75,0,62,0,1076,0
alpharetta47,alpharetta47,,0,1,1,0,1,1,1,1,1,0,29,0,1077,0
oiarte,oiarte,,1,1,2,1,1,2,0,0,0,0,63,38,1078,0
BassoMouro,BassoMouro,,0,1,1,0,1,1,1,1,1,0,64,39,1080,0
LucianoHuck,LucianoHuck,,1,0,1,1,0,1,0,0,0,0,64,39,1079,0
VerdeViver,VerdeViver,,0,2,2,0,12,12,2,0.6,0.666667,0,10,0,1081,0.5
MbWander,MbWander,,0,1,1,0,1,1,1,1,1,0,4,0,1082,0
edson_cortez,edson_cortez,,0,1,1,0,1,1,1,1,1,0,4,0,1083,0
PiraNaPamonha,PiraNaPamonha,,0,1,1,0,1,1,2,0.545455,0.583333,0,10,0,1084,0
jcatino,jcatino,,0,1,1,0,2,2,2,0.545455,0.583333,0,10,0,1085,0
TalitaFatima,TalitaFatima,,0,1,1,0,4,4,2,0.545455,0.583333,0,10,0,1086,0
SandraOvelha,SandraOvelha,,0,1,1,0,1,1,1,1,1,0,5,0,1087,0
zenaide2208,zenaide2208,,0,1,1,0,1,1,2,0.545455,0.583333,0,10,0,1088,0
EdrisiaAlves,EdrisiaAlves,,0,1,1,0,1,1,1,1,1,0,5,0,1089,0
Elilikx,Elilikx,,0,1,1,0,4,4,2,0.545455,0.583333,0,10,0,1090,0
mainesteixeira,mainesteixeira,,0,1,1,0,1,1,2,0.545455,0.583333,0,10,0,1091,0
onkoto3,onkoto3,,0,1,1,0,4,4,2,0.545455,0.583333,0,10,0,1092,0
Surtei,Surtei,,0,1,1,0,1,1,1,1,1,0,5,0,1093,0
GovRJ,GovRJ,,2,1,3,2,2,4,1,1,1,0,5,0,1094,0.333333
Lima70269971,Lima70269971,,0,2,2,0,2,2,1,1,1,0,27,0,1095,0
UOLNoticias,UOLNoticias,,10,0,10,20,0,20,0,0,0,0,27,0,54,0.033333
UOL,UOL,,7,0,7,16,0,16,0,0,0,0,27,0,87,0.071429
charlesoliveira,charlesoliveira,,0,2,2,0,4,4,2,0.666667,0.75,0,62,0,1096,0
Robert1_Marinho,Robert1_Marinho,,0,2,2,0,2,2,2,0.666667,0.75,0,62,0,1097,0
nossyrrahfds1,nossyrrahfds1,,0,2,2,0,2,2,2,0.666667,0.75,0,62,0,1098,0
EAzouf,EAzouf,,0,2,2,0,5,5,2,0.666667,0.75,0,62,0,1099,0
ubcomini,ubcomini,,0,1,1,0,1,1,1,1,1,0,62,0,1100,0
UNEP_pt,UNEP_pt,,4,0,4,4,0,4,0,0,0,0,62,0,501,0
BenOlivDreamer,BenOlivDreamer,,1,1,2,1,1,2,2,0.545455,0.583333,0,10,0,1101,0
Adorotecnologia,Adorotecnologia,,0,2,2,0,3,3,2,0.6,0.666667,0,10,0,1102,0.5
twentyclikkie,twentyclikkie,,0,1,1,0,1,1,1,1,1,0,4,0,1103,0
FelipePousada,FelipePousada,,0,2,2,0,2,2,1,1,1,0,125,0,1104,0.5
Macrina20776766,Macrina20776766,,0,2,2,0,2,2,1,1,1,0,45,0,1106,0
andersongtorres,andersongtorres,,1,0,1,1,0,1,0,0,0,0,45,0,1105,0
mandajob,mandajob,,0,1,1,0,1,1,1,1,1,0,4,0,1107,0
RebessiVeras,RebessiVeras,,0,1,1,0,1,1,1,1,1,0,4,0,1108,0
PBarrionuevoJr,PBarrionuevoJr,,0,1,1,0,3,3,1,1,1,0,65,40,1110,0
trtmatogrosso,trtmatogrosso,,1,0,1,3,0,3,0,0,0,0,65,40,1109,0
Taninha_03,Taninha_03,,0,1,1,0,1,1,1,1,1,0,4,0,1111,0
FabiolaCantilho,FabiolaCantilho,,0,1,1,0,1,1,2,0.571429,0.625,0,5,0,1112,0
MacielAlves2021,MacielAlves2021,,0,1,1,0,1,1,1,1,1,0,4,0,1113,0
Natanyel_vasco,Natanyel_vasco,,0,1,1,0,1,1,1,1,1,0,4,0,1114,0
cleide_ita,cleide_ita,,0,3,3,0,7,7,1,1,1,0,4,0,1115,0.166667
JoaoCampoGrande,JoaoCampoGrande,,0,2,2,0,2,2,2,0.666667,0.75,0,62,0,1116,0
AndradeGeida,AndradeGeida,,0,2,2,0,2,2,1,1,1,0,125,0,1117,0.5
Fabricio_Carva,Fabricio_Carva,,0,1,1,0,4,4,1,1,1,0,66,0,1118,0
diariodegoias,diariodegoias,,6,1,7,14,1,15,0,0,0,0,66,0,217,0.166667
RitaaTomas,RitaaTomas,,0,1,1,0,1,1,1,1,1,0,67,41,1120,0
foco_project,foco_project,,2,0,2,2,0,2,0,0,0,0,67,41,1119,0
alexlimareal,alexlimareal,,1,1,2,4,1,5,1,1,1,0,0,0,256,0.5
adbrasil,adbrasil,,2,1,3,6,1,7,1,1,1,0,0,0,255,0.166667
laraslsilva,laraslsilva,,0,1,1,0,1,1,1,1,1,0,67,41,1121,0
ChillanejaD,ChillanejaD,,0,1,1,0,1,1,1,1,1,0,68,42,1123,0
dridelatorre,dridelatorre,,5,0,5,5,0,5,0,0,0,0,68,42,1122,0
FabianoCFX,FabianoCFX,,0,2,2,0,5,5,2,0.666667,0.75,0,62,0,1124,0
Midia1508,Midia1508,,0,2,2,0,2,2,1,1,1,0,76,0,1125,1
negacionista20,negacionista20,,0,1,1,0,1,1,2,0.666667,0.75,0,10,0,1126,0
FrederKamen,FrederKamen,,6,1,7,10,1,11,1,1,1,0,10,0,398,0.047619
smbuarque,smbuarque,,0,1,1,0,1,1,1,1,1,0,10,0,1127,0
mzconteudo,mzconteudo,,6,0,6,6,0,6,0,0,0,0,10,0,400,0
Griffoneye,Griffoneye,,0,1,1,0,1,1,1,1,1,0,69,43,1129,0
supersamuellima,supersamuellima,,2,0,2,2,0,2,0,0,0,0,69,43,1128,0
SrgioRi96314290,SrgioRi96314290,,0,2,2,0,2,2,1,1,1,0,125,0,1130,0.5
MinesFalcao,MinesFalcao,,0,1,1,0,1,1,2,0.545455,0.583333,0,10,0,1131,0
BleyLacerda,BleyLacerda,,0,1,1,0,1,1,2,0.545455,0.583333,0,10,0,1132,0
FernandoEscot13,FernandoEscot13,,0,1,1,0,1,1,1,1,1,0,70,44,1134,0
XiomaraCastroZ,XiomaraCastroZ,,1,0,1,1,0,1,0,0,0,0,70,44,1133,0
AngelNar007,AngelNar007,,0,2,2,0,2,2,1,1,1,0,125,0,1135,0.5
lulamontt63,lulamontt63,,0,1,1,0,1,1,1,1,1,0,68,42,1136,0
rafavrin,rafavrin,,0,3,3,0,4,4,2,0.615385,0.6875,0,10,0,1137,0.166667
Eli237809,Eli237809,,0,2,2,0,3,3,2,0.583333,0.642857,0,10,0,1138,0
irfanmalikkhan,irfanmalikkhan,,0,2,2,0,2,2,2,0.75,0.833333,0,31,0,1139,0.5
UNICEF,UNICEF,,7,0,7,7,0,7,0,0,0,0,31,0,7,0.142857
MouraF68315579,MouraF68315579,,0,2,2,0,2,2,2,0.75,0.833333,0,71,0,1143,0.5
imperialtiago,imperialtiago,,22,2,24,24,2,26,1,1,1,0.000001,71,0,1142,0.038043
Clauwild1,Clauwild1,,15,0,15,15,0,15,0,0,0,0,71,0,1140,0.066667
diarioudi,diarioudi,,3,0,3,4,0,4,0,0,0,0,10,0,142,0
BolsonaroFerro,BolsonaroFerro,,0,2,2,0,2,2,1,1,1,0,125,0,1144,0.5
gisellesouza73,gisellesouza73,,0,1,1,0,1,1,1,1,1,0,10,0,1145,0
DuduFlu1981,DuduFlu1981,,0,2,2,0,2,2,1,1,1,0,125,0,1146,0.5
SamuelA47607293,SamuelA47607293,,0,1,1,0,2,2,1,1,1,0,8,0,1147,0
garciaegarcia,garciaegarcia,,0,1,1,0,1,1,2,0.545455,0.583333,0,10,0,1148,0
boxwordnews,boxwordnews,,0,1,1,0,1,1,1,1,1,0,72,45,1150,0
BoxWorldnewsBr,BoxWorldnewsBr,,1,0,1,1,0,1,0,0,0,0,72,45,1149,0
aronbmoura,aronbmoura,,0,1,1,0,1,1,2,0.545455,0.583333,0,10,0,1151,0
beatrizdiniz,beatrizdiniz,,3,1,4,11,1,12,1,1,1,0,0,0,254,0
SoniaCa40140057,SoniaCa40140057,,0,2,2,0,2,2,1,1,1,0,125,0,1153,0.5
AntonioLEMEFIL1,AntonioLEMEFIL1,,3,1,4,3,1,4,1,1,1,0,125,0,1152,0.25
benhurcamacho,benhurcamacho,,0,1,1,0,1,1,1,1,1,0,4,0,1154,0
portal_scc10,portal_scc10,,1,0,1,1,0,1,0,0,0,0,0,0,253,0
gabircnunes,gabircnunes,,1,0,1,1,0,1,0,0,0,0,5,0,714,0
angelablorena,angelablorena,,0,1,1,0,1,1,1,1,1,0,41,0,1155,0
GuilhermeLTdr,GuilhermeLTdr,,0,1,1,0,1,1,1,1,1,0,73,0,1156,0
Lealjoao77,Lealjoao77,,53,0,53,53,0,53,0,0,0,0,73,0,345,0
LucianaTriguei3,LucianaTriguei3,,0,1,1,0,1,1,1,1,1,0,73,0,1157,0
F1Admirador,F1Admirador,,0,1,1,0,1,1,1,1,1,0,62,0,1158,0
tiagogonzaga,tiagogonzaga,,0,1,1,0,1,1,1,1,1,0,41,0,1159,0
pukemylungs,pukemylungs,,0,1,1,0,1,1,2,0.545455,0.583333,0,10,0,1160,0
JuarezSantAnaJ1,JuarezSantAnaJ1,,0,1,1,0,1,1,1,1,1,0,73,0,1161,0
unfinanciero_mx,unfinanciero_mx,,0,1,1,0,1,1,1,1,1,0,74,0,1162,0
UniCienciaGM,UniCienciaGM,,3,0,3,3,0,3,0,0,0,0,74,0,399,0
glaueva12,glaueva12,,0,2,2,0,2,2,1,1,1,0,76,0,1163,1
sceiffer,sceiffer,,0,3,3,0,3,3,1,1,1,0,75,46,1167,0
OdairDuarte17,OdairDuarte17,,1,0,1,1,0,1,0,0,0,0,75,46,1166,0
joicehasselmann,joicehasselmann,,1,0,1,1,0,1,0,0,0,0,75,46,1165,0
ptbrasil,ptbrasil,,1,0,1,1,0,1,0,0,0,0,75,46,1164,0
la_monstruita,la_monstruita,,0,1,1,0,1,1,1,1,1,0,5,0,1168,0
turnoffthecam,turnoffthecam,,0,1,1,0,1,1,1,1,1,0,8,0,1169,0
GustavoBarreto_,GustavoBarreto_,,0,1,1,0,1,1,2,0.6,0.666667,0,31,0,1170,0
FUmbuzeiro,FUmbuzeiro,,0,3,3,0,3,3,1,1,1,0,76,0,1173,0
FAOBrasil,FAOBrasil,,1,0,1,1,0,1,0,0,0,0,76,0,1172,0
andersonleao16,andersonleao16,,3,0,3,3,0,3,0,0,0,0,5,0,713,0
renato_ssouza,renato_ssouza,,0,1,1,0,3,3,2,0.545455,0.583333,0,10,0,1174,0
juRR124,juRR124,,0,3,3,0,7,7,4,0.464912,0.496855,0,10,0,1175,0.333333
KarineSerpa_,KarineSerpa_,,0,1,1,0,1,1,2,0.666667,0.75,0,0,0,1176,0
FabioPlatero1,FabioPlatero1,,0,2,2,0,2,2,2,0.75,0.833333,0,71,0,1177,0.5
RockMachine9,RockMachine9,,0,2,2,0,4,4,2,0.571429,0.625,0,10,0,1178,0
daniwon,daniwon,,0,1,1,0,1,1,1,1,1,0,4,0,1179,0
MaCoutocris,MaCoutocris,,0,1,1,0,1,1,2,0.545455,0.583333,0,10,0,1180,0
GeremiasDalmaz,GeremiasDalmaz,,0,1,1,0,1,1,1,1,1,0,5,0,1181,0
Jack44846841,Jack44846841,,0,2,2,0,2,2,2,0.75,0.833333,0,71,0,1182,0.5
silvia92745700,silvia92745700,,0,1,1,0,1,1,1,1,1,0,77,47,1184,0
ganga2410,ganga2410,,1,0,1,1,0,1,0,0,0,0,77,47,1183,0
SChonso17,SChonso17,,0,1,1,0,1,1,1,1,1,0,78,48,1186,0
juank23_7,juank23_7,,1,0,1,1,0,1,0,0,0,0,78,48,1185,0
CarrociniDe,CarrociniDe,,0,3,3,0,7,7,2,0.666667,0.75,0,10,0,1187,0.666667
SeverinoFeijo,SeverinoFeijo,,0,2,2,0,2,2,1,1,1,0,125,0,1188,0.5
Luiz_CR_Cwb,Luiz_CR_Cwb,,0,1,1,0,2,2,2,0.666667,0.75,0,10,0,1189,0
Vander_Khann,Vander_Khann,,0,2,2,0,2,2,1,1,1,0,125,0,1190,0.5
alexandrefatec,alexandrefatec,,0,1,1,0,1,1,1,1,1,0,73,0,1191,0
NotFascismInBR,NotFascismInBR,,1,2,3,1,3,4,1,1,1,0,79,49,1193,0.5
gustones,gustones,,1,0,1,2,0,2,0,0,0,0,79,49,1192,0
Silviavont,Silviavont,,0,1,1,0,1,1,2,0.545455,0.583333,0,10,0,1194,0
CCR_IOS20,CCR_IOS20,,0,1,1,0,1,1,1,1,1,0,213,0,1195,0
wilsondenotari,wilsondenotari,,0,1,1,0,8,8,1,1,1,0,80,0,1196,0
gabrielaitto,gabrielaitto,,11,1,12,25,1,26,0,0,0,0,80,0,397,0.090909
patrulhaptralha,patrulhaptralha,,0,1,1,0,2,2,2,0.666667,0.75,0,10,0,1197,0
primasilenciosa,primasilenciosa,,0,1,1,0,3,3,2,0.545455,0.583333,0,10,0,1198,0
GGsavoy,GGsavoy,,0,2,2,0,7,7,2,0.583333,0.642857,0,10,0,1199,0
Cidda11,Cidda11,,0,1,1,0,1,1,1,1,1,0,10,0,1200,0
guadecy,guadecy,,0,2,2,0,2,2,1,1,1,0,81,50,1203,0
pslnacamara,pslnacamara,,7,0,7,7,0,7,0,0,0,0,81,50,1202,0
carlosjordy,carlosjordy,,7,0,7,7,0,7,0,0,0,0,81,50,1201,0
claudiasrocca,claudiasrocca,,0,1,1,0,1,1,2,0.6,0.666667,0,62,0,1204,0
CeliaMoraisCar1,CeliaMoraisCar1,,0,2,2,0,2,2,1,1,1,0,125,0,1205,0.5
SandraM95965906,SandraM95965906,,0,2,2,0,6,6,1,1,1,0,8,0,1207,0
coachingmoura,coachingmoura,,1,1,2,1,1,2,1,1,1,0,62,0,1209,0
Estadao,Estadao,,3,0,3,3,0,3,0,0,0,0,62,0,1208,0
thiagodiasdm,thiagodiasdm,,0,2,2,0,2,2,1,1,1,0,45,0,1210,0
hansoficial,hansoficial,,0,2,2,0,2,2,1,1,1,0,125,0,1211,0.5
tririos,tririos,,0,1,1,0,1,1,2,0.545455,0.583333,0,10,0,1212,0
wellingtoncmps,wellingtoncmps,,0,1,1,0,1,1,2,0.545455,0.583333,0,10,0,1213,0
joaolagojunior,joaolagojunior,,0,2,2,0,2,2,1,1,1,0,125,0,1214,0.5
dogarrett,dogarrett,,3,0,3,6,0,6,0,0,0,0,0,0,80,0.333333
MariaJo95009889,MariaJo95009889,,0,2,2,0,2,2,1,1,1,0,125,0,1215,0.5
HdaBahia,HdaBahia,,0,1,1,0,2,2,1,1,1,0,80,0,1216,0
lilica_11,lilica_11,,0,2,2,0,2,2,1,1,1,0,125,0,1217,0.5
CsarBarZin,CsarBarZin,,0,2,2,0,2,2,1,1,1,0,125,0,1218,0.5
DorettaOpcruz,DorettaOpcruz,,0,1,1,0,1,1,1,1,1,0,80,0,1219,0
OsvaldoRibeiroF,OsvaldoRibeiroF,,0,2,2,0,2,2,1,1,1,0,27,0,1221,0
wilsonwitzel,wilsonwitzel,,1,0,1,1,0,1,0,0,0,0,27,0,1220,0
Betojanf,Betojanf,,0,2,2,0,2,2,1,1,1,0,125,0,1222,0.5
HedaWarr,HedaWarr,,0,1,1,0,1,1,1,1,1,0,80,0,1223,0
Sun_Moon_13,Sun_Moon_13,,0,9,9,0,12,12,2,0.736842,0.821429,0,80,0,1229,0.013889
cybersec_feeds,cybersec_feeds,,0,1,1,0,1,1,1,1,1,0,86,51,1231,0
seosmmworld1,seosmmworld1,,7,0,7,8,0,8,0,0,0,0,86,51,1230,0
BravoLucilene,BravoLucilene,,0,2,2,0,2,2,1,1,1,0,125,0,1232,0.5
WambierMD,WambierMD,,0,1,1,0,1,1,2,0.666667,0.75,0,19,0,1234,0
alinefortuna2,alinefortuna2,,1,1,2,1,1,2,1,1,1,0,19,0,1233,0
Warley_Lopes,Warley_Lopes,,0,5,5,0,5,5,1,1,1,0,125,0,1235,0.15
femigueres,femigueres,,0,2,2,0,2,2,2,0.75,0.833333,0,71,0,1236,0.5
marriliberato92,marriliberato92,,0,1,1,0,2,2,1,1,1,0,10,0,1237,0
tatianacajado,tatianacajado,,0,1,1,0,1,1,1,1,1,0,45,0,1238,0
Rosaquel22,Rosaquel22,,0,2,2,0,2,2,1,1,1,0,125,0,1239,0.5
ethienearruda,ethienearruda,,0,1,1,0,1,1,1,1,1,0,27,0,1240,0
oatila,oatila,,3,0,3,12,0,12,0,0,0,0,27,0,91,0
patyquinan,patyquinan,,0,2,2,0,2,2,1,1,1,0,125,0,1241,0.5
Leonard29003696,Leonard29003696,,0,1,1,0,5,5,2,0.545455,0.583333,0,10,0,1242,0
Lina7Soares,Lina7Soares,,0,1,1,0,1,1,1,1,1,0,8,0,1243,0
lipesantosrj,lipesantosrj,,0,2,2,0,2,2,1,1,1,0,125,0,1244,0.5
RenatoAmorim65,RenatoAmorim65,,0,2,2,0,2,2,1,1,1,0,125,0,1245,0.5
MCJohn61699095,MCJohn61699095,,0,2,2,0,2,2,1,1,1,0,125,0,1246,0.5
maradeboni,maradeboni,,0,1,1,0,1,1,1,1,1,0,0,0,1247,0
daniellimas,daniellimas,,2,0,2,2,0,2,0,0,0,0,0,0,20,0
davidscris,davidscris,,0,1,1,0,1,1,1,1,1,0,8,0,1248,0
ribeiro519,ribeiro519,,0,1,1,0,2,2,1,1,1,0,8,0,1249,0
diogoemcs,diogoemcs,,0,1,1,0,1,1,2,0.545455,0.583333,0,10,0,1250,0
Ghost_Comuna,Ghost_Comuna,,0,2,2,0,2,2,2,0.666667,0.75,0,62,0,1251,0
ricsanto,ricsanto,,0,2,2,0,2,2,2,0.666667,0.75,0,62,0,1252,0
internacionalzp,internacionalzp,,0,3,3,0,9,9,1,1,1,0,71,0,1254,0
zinhademerda,zinhademerda,,0,1,1,0,1,1,2,0.545455,0.583333,0,10,0,1255,0
BarreiraCecilia,BarreiraCecilia,,1,0,1,1,0,1,0,0,0,0,20,0,388,0
AmericoAlmeida7,AmericoAlmeida7,,1,0,1,3,0,3,0,0,0,0,20,0,387,0
veronicastigger,veronicastigger,,0,1,1,0,1,1,2,0.545455,0.583333,0,10,0,1256,0
Marilen21183970,Marilen21183970,,0,1,1,0,2,2,2,0.6,0.666667,0,31,0,1257,0
abiliomurce,abiliomurce,,0,5,5,0,5,5,1,1,1,0,0,0,1262,0
radioitatiaia,radioitatiaia,,1,0,1,1,0,1,0,0,0,0,0,0,1261,0
Atletico,Atletico,,1,0,1,1,0,1,0,0,0,0,0,0,1260,0
LibertyNow22,LibertyNow22,,0,2,2,0,2,2,2,0.75,0.833333,0,71,0,1263,0.5
IESC_UFRJ,IESC_UFRJ,,0,1,1,0,1,1,1,1,1,0,76,0,1264,0
PNUDBrasil,PNUDBrasil,,4,0,4,4,0,4,0,0,0,0,76,0,639,0
JohnsHopkinsSPH,JohnsHopkinsSPH,,1,0,1,2,0,2,0,0,0,0,27,0,98,0
JohnsHopkins,JohnsHopkins,,1,0,1,2,0,2,0,0,0,0,27,0,97,0
coursera,coursera,,1,0,1,2,0,2,0,0,0,0,27,0,96,0
GrandeReset,GrandeReset,,0,3,3,0,4,4,2,0.8,0.875,0,71,0,1265,0.166667
laricelvis,laricelvis,,0,1,1,0,1,1,1,1,1,0,82,52,1267,0
exercitooficial,exercitooficial,,1,0,1,1,0,1,0,0,0,0,82,52,1266,0
teamcomicss,teamcomicss,,1,1,2,1,1,2,1,1,1,0,10,0,381,0.5
natgeobrasil,natgeobrasil,,2,0,2,2,0,2,0,0,0,0,10,0,380,0.5
feanjs,feanjs,,0,1,1,0,1,1,1,1,1,0,4,0,1268,0
thiagoreisbh,thiagoreisbh,,1,0,1,1,0,1,0,0,0,0,0,0,1259,0
AmericaMG,AmericaMG,,1,0,1,1,0,1,0,0,0,0,0,0,1258,0
lidiavieira,lidiavieira,,0,2,2,0,2,2,2,0.75,0.833333,0,71,0,1269,0.5
nonaGeGe,nonaGeGe,,0,2,2,0,2,2,1,1,1,0,125,0,1270,0.5
roberto24554419,roberto24554419,,0,1,1,0,2,2,1,1,1,0,83,53,1272,0
CNJ_oficial,CNJ_oficial,,1,0,1,2,0,2,0,0,0,0,83,53,1271,0
asergioferri29,asergioferri29,,0,2,2,0,2,2,1,1,1,0,125,0,1273,0.5
mayaradesaviei1,mayaradesaviei1,,0,2,2,0,2,2,1,1,1,0,88,0,1274,0
juliocroda,juliocroda,,2,0,2,5,0,5,0,0,0,0,27,0,69,1
lorenagbarberia,lorenagbarberia,,2,0,2,2,0,2,0,0,0,0,27,0,68,1
Fofodeneve,Fofodeneve,,0,2,2,0,2,2,1,1,1,0,125,0,1275,0.5
jmm45_,jmm45_,,1,12,13,1,33,34,2,0.875,0.928571,0.000001,5,0,138,0.038462
Phcruz7,Phcruz7,,0,2,2,0,2,2,1,1,1,0,125,0,1276,0.5
vvlgarism,vvlgarism,,0,1,1,0,1,1,1,1,1,0,8,0,1277,0
LCAMiranda,LCAMiranda,,0,2,2,0,2,2,1,1,1,0,125,0,1278,0.5
pthago,pthago,,0,1,1,0,1,1,2,0.666667,0.75,0,84,0,1279,0
governoTO,governoTO,,6,1,7,6,1,7,1,1,1,0,84,0,379,0.066667
caliljuniot,caliljuniot,,0,2,2,0,2,2,1,1,1,0,125,0,1280,0.5
CelebridadesDas,CelebridadesDas,,0,11,11,0,11,11,3,0.517857,0.574713,0,27,0,1283,0.109091
NobreRS,NobreRS,,0,4,4,0,4,4,2,0.833333,0.9,0,125,0,1284,0.083333
AleQueiros10,AleQueiros10,,0,2,2,0,2,2,1,1,1,0,125,0,1285,0.5
marinahkhl,marinahkhl,,0,2,2,0,3,3,2,0.6,0.666667,0,10,0,1286,0.5
Danielaalmeida8,Danielaalmeida8,,0,1,1,0,4,4,2,0.571429,0.625,0,5,0,1287,0
gurudaleffe,gurudaleffe,,0,1,1,0,1,1,1,1,1,0,85,54,1289,0
CSobania,CSobania,,1,0,1,1,0,1,0,0,0,0,85,54,1288,0
jassonquirino,jassonquirino,,0,1,1,0,1,1,2,0.666667,0.75,0,84,0,1290,0
Ivojunior76,Ivojunior76,,0,5,5,0,5,5,1,1,1,0,0,0,1291,0
randolfeap,randolfeap,,4,0,4,4,0,4,0,0,0,0,0,0,155,0.166667
renancalheiros,renancalheiros,,4,0,4,4,0,4,0,0,0,0,0,0,152,0.166667
OmarAzizSenador,OmarAzizSenador,,5,0,5,9,0,9,0,0,0,0,0,0,156,0.15
LuizCarlosPest9,LuizCarlosPest9,,0,2,2,0,2,2,2,0.75,0.833333,0,71,0,1292,0.5
01_victorsouza,01_victorsouza,,0,1,1,0,6,6,1,1,1,0,5,0,1293,0
MarioCalvano1,MarioCalvano1,,0,2,2,0,3,3,2,0.583333,0.642857,0,10,0,1294,0
dr_nesio,dr_nesio,,12,0,12,12,0,12,0,0,0,0,213,0,375,0
descabidela,descabidela,,0,1,1,0,1,1,1,1,1,0,8,0,1295,0
Francis16499862,Francis16499862,,0,2,2,0,2,2,1,1,1,0,125,0,1296,0.5
FtimadeFtima1,FtimadeFtima1,,0,4,4,0,7,7,4,0.473214,0.509434,0,27,0,1297,0.5
ricardosantos,ricardosantos,,1,0,1,1,0,1,0,0,0,0,10,0,378,0
ORibauu,ORibauu,,0,1,1,0,1,1,1,1,1,0,8,0,1298,0
garotadpi,garotadpi,,0,2,2,0,4,4,2,0.583333,0.642857,0,10,0,1299,0
V69765183,V69765183,,0,2,2,0,2,2,2,0.75,0.833333,0,71,0,1300,0.5
ManhosaLeoa,ManhosaLeoa,,0,3,3,0,3,3,1,1,1,0,8,0,1301,0.333333
diraquel,diraquel,,0,1,1,0,3,3,1,1,1,0,8,0,1302,0
giovannibotelho,giovannibotelho,,0,2,2,0,2,2,1,1,1,0,125,0,1303,0.5
CoderRetweet,CoderRetweet,,0,1,1,0,1,1,1,1,1,0,86,51,1304,0
Aoshi_K,Aoshi_K,,0,1,1,0,3,3,1,1,1,0,38,0,1305,0
AngolaOms,AngolaOms,,0,2,2,0,3,3,2,0.75,0.833333,0,31,0,1306,0.5
EJaspion,EJaspion,,0,1,1,0,1,1,2,0.6,0.666667,0,71,0,1307,0
ivan_lemos,ivan_lemos,,0,1,1,0,2,2,1,1,1,0,38,0,1308,0
Josiane_r,Josiane_r,,0,2,2,0,2,2,1,1,1,0,76,0,1309,0
PesquisaFapesp,PesquisaFapesp,,11,0,11,14,0,14,0,0,0,0,76,0,222,0
LetsCode15,LetsCode15,,0,1,1,0,1,1,1,1,1,0,86,51,1310,0
reginage,reginage,,0,2,2,0,2,2,1,1,1,0,125,0,1311,0.5
morolswediu,morolswediu,,0,1,1,0,1,1,1,1,1,0,86,51,1312,0
zabssexual,zabssexual,,0,2,2,0,2,2,1,1,1,0,125,0,1313,0.5
PythonRoboto,PythonRoboto,,0,1,1,0,1,1,1,1,1,0,86,51,1314,0
PythonbotBr,PythonbotBr,,0,1,1,0,2,2,1,1,1,0,86,51,1315,0
TheDeveloperBot,TheDeveloperBot,,0,1,1,0,1,1,1,1,1,0,86,51,1316,0
jopesanvieira,jopesanvieira,,0,1,1,0,1,1,1,1,1,0,38,0,1317,0
LucasDa04048048,LucasDa04048048,,0,2,2,0,2,2,1,1,1,0,81,50,1318,0
ArrieiroJose,ArrieiroJose,,0,2,2,0,2,2,1,1,1,0,125,0,1319,0.5
LuizMS2017,LuizMS2017,,0,2,2,0,2,2,1,1,1,0,125,0,1320,0.5
williambenthon,williambenthon,,0,1,1,0,1,1,2,0.666667,0.75,0,0,0,1321,0
hbghelio,hbghelio,,0,1,1,0,1,1,1,1,1,0,38,0,1322,0
Herval68461744,Herval68461744,,0,2,2,0,2,2,2,0.75,0.833333,0,71,0,1323,0.5
lhamanalama,lhamanalama,,0,1,1,0,2,2,1,1,1,0,38,0,1324,0
faydeazevedo,faydeazevedo,,1,2,3,1,2,3,1,1,1,0,4,0,248,0.333333
danielliguerson,danielliguerson,,0,2,2,0,2,2,1,1,1,0,125,0,1325,0.5
Jorgebalin67,Jorgebalin67,,0,1,1,0,1,1,1,1,1,0,0,0,1326,0
ReginaPortella3,ReginaPortella3,,0,2,2,0,2,2,1,1,1,0,125,0,1327,0.5
heliolombardia1,heliolombardia1,,0,2,2,0,2,2,1,1,1,0,125,0,1328,0.5
coelho_clemente,coelho_clemente,,2,1,3,2,1,3,1,1,1,0,87,55,1330,0.333333
prefrecife,prefrecife,,3,0,3,3,0,3,0,0,0,0,87,55,1329,0.333333
AlagoasReal,AlagoasReal,,2,0,2,4,0,4,0,0,0,0,0,0,247,0
flaviomilm,flaviomilm,,0,1,1,0,1,1,1,1,1,0,10,0,1331,0
econobrasil,econobrasil,,0,1,1,0,1,1,1,1,1,0,88,0,1332,0
CUT_Brasil,CUT_Brasil,,29,0,29,31,0,31,0,0,0,0,88,0,377,0
EdilsonA00013,EdilsonA00013,,0,1,1,0,1,1,1,1,1,0,88,0,1333,0
JoseAloiseBahia,JoseAloiseBahia,,0,2,2,0,3,3,1,1,1,0,88,0,1334,0
marcelo34776760,marcelo34776760,,0,3,3,0,4,4,2,0.636364,0.714286,0,10,0,1335,0.166667
JullyMoreira9,JullyMoreira9,,0,1,1,0,1,1,1,1,1,0,89,56,1337,0
oficialmussi,oficialmussi,,1,0,1,1,0,1,0,0,0,0,89,56,1336,0
Cludio88642048,Cludio88642048,,0,2,2,0,2,2,1,1,1,0,125,0,1338,0.5
br_domingos,br_domingos,,0,1,1,0,1,1,2,0.545455,0.583333,0,10,0,1339,0
isabellaym_79,isabellaym_79,,1,0,1,1,0,1,0,0,0,0,0,0,246,0
NabucoRamos,NabucoRamos,,0,2,2,0,2,2,1,1,1,0,125,0,1340,0.5
JornalFla10,JornalFla10,,2,3,5,3,5,8,1,1,1,0,90,57,1343,0.333333
juliamalak,juliamalak,,1,0,1,1,0,1,0,0,0,0,90,57,1342,0
LaercioAmaralJ1,LaercioAmaralJ1,,0,2,2,0,2,2,1,1,1,0,125,0,1344,0.5
alberidias,alberidias,,0,2,2,0,2,2,2,0.625,0.7,0,5,0,1345,0
MizaoC,MizaoC,,0,2,2,0,2,2,2,0.75,0.833333,0,71,0,1346,0.5
soujhom,soujhom,,0,2,2,0,2,2,1,1,1,0,125,0,1347,0.5
resendeandrade1,resendeandrade1,,0,1,1,0,2,2,2,0.545455,0.583333,0,10,0,1348,0
elyjoao2,elyjoao2,,0,2,2,0,2,2,1,1,1,0,125,0,1349,0.5
elomarModerno,elomarModerno,,0,2,2,0,2,2,1,1,1,0,125,0,1350,0.5
YinYangRN,YinYangRN,,0,2,2,0,2,2,1,1,1,0,125,0,1351,0.5
mariasinha28,mariasinha28,,0,1,1,0,4,4,2,0.545455,0.583333,0,10,0,1352,0
D1Jimenez,D1Jimenez,,0,1,1,0,2,2,1,1,1,0,29,0,1353,0
PodcastRioBravo,PodcastRioBravo,,0,3,3,0,3,3,1,1,1,0,62,0,1355,0
JornalOGlobo,JornalOGlobo,,2,0,2,2,0,2,0,0,0,0,62,0,1354,0
Russimeire1,Russimeire1,,0,2,2,0,5,5,2,0.6,0.666667,0,10,0,1356,0.5
suyrecife,suyrecife,,0,2,2,0,2,2,1,1,1,0,125,0,1357,0.5
MNessuna,MNessuna,,0,5,5,0,6,6,4,0.474138,0.515152,0,27,0,1358,0.25
patycastelan,patycastelan,,0,3,3,0,3,3,4,0.452991,0.487421,0,27,0,1359,0.5
Capyvara,Capyvara,,9,1,10,9,1,10,1,1,1,0,27,0,94,0.1
crisvector,crisvector,,10,6,16,10,6,16,3,0.495238,0.535256,0.000005,27,0,99,0.12381
AparecidoDomi15,AparecidoDomi15,,0,2,2,0,2,2,1,1,1,0,125,0,1360,0.5
leivamoura,leivamoura,,0,3,3,0,3,3,2,0.615385,0.6875,0,76,0,1361,0.333333
NDaSilva6,NDaSilva6,,0,1,1,0,1,1,2,0.545455,0.583333,0,10,0,1362,0
BetoKavalcante,BetoKavalcante,,1,0,1,1,0,1,0,0,0,0,0,0,245,0
ana_llouise,ana_llouise,,0,7,7,0,12,12,2,0.733333,0.818182,0,10,0,1363,0.095238
MMSilveira3,MMSilveira3,,0,2,2,0,2,2,1,1,1,0,125,0,1364,0.5
madpaz,madpaz,,0,2,2,0,2,2,1,1,1,0,125,0,1365,0.5
GabrielDiniz75,GabrielDiniz75,,0,1,1,0,1,1,1,1,1,0,91,58,1367,0
carrefourbrasil,carrefourbrasil,,1,0,1,1,0,1,0,0,0,0,91,58,1366,0
MarinesMoura,MarinesMoura,,0,1,1,0,2,2,2,0.545455,0.583333,0,10,0,1368,0
doutorleonardo,doutorleonardo,,0,1,1,0,1,1,1,1,1,0,213,0,1369,0
CarlinhosAV,CarlinhosAV,,0,2,2,0,2,2,2,0.6,0.666667,0,10,0,1370,0.5
GOPIRA,GOPIRA,,0,2,2,0,2,2,1,1,1,0,125,0,1371,0.5
mariujo,mariujo,,0,1,1,0,1,1,2,0.6,0.666667,0,31,0,1372,0
joseald24442373,joseald24442373,,0,2,2,0,2,2,1,1,1,0,125,0,1373,0.5
Fernandapere,Fernandapere,,0,2,2,0,4,4,2,0.6,0.666667,0,10,0,1374,0.5
eduardobaiareis,eduardobaiareis,,0,4,4,0,4,4,1,1,1,0,92,59,1379,0
bowsofbosses,bowsofbosses,,1,0,1,1,0,1,0,0,0,0,92,59,1378,0
Binoculocultura,Binoculocultura,,0,1,1,0,1,1,1,1,1,0,93,60,1381,0
anysenna_ana,anysenna_ana,,1,0,1,1,0,1,0,0,0,0,93,60,1380,0
Fazedores1,Fazedores1,,0,1,1,0,2,2,2,0.571429,0.625,0,94,61,1386,0
rodrigosette,rodrigosette,,2,3,5,3,4,7,1,1,1,0,94,61,1385,0
sanjusahahindu,sanjusahahindu,,0,2,2,0,2,2,2,0.75,0.833333,0,31,0,1387,0.5
CarlaMo03788353,CarlaMo03788353,,0,1,1,0,1,1,2,0.6,0.666667,0,31,0,1388,0
Jcyagami10,Jcyagami10,,0,1,1,0,1,1,1,1,1,0,95,62,1390,0
tiaprinotwiter,tiaprinotwiter,,2,0,2,2,0,2,0,0,0,0,95,62,1389,0
hippiecartman,hippiecartman,,0,1,1,0,1,1,2,0.545455,0.583333,0,10,0,1391,0
Vini_Dominguees,Vini_Dominguees,,0,2,2,0,2,2,1,1,1,0,125,0,1392,0.5
Jorgetap2021,Jorgetap2021,,0,4,4,0,4,4,2,0.666667,0.75,0,125,0,1393,0.166667
camposmendonca,camposmendonca,,0,3,3,0,3,3,4,0.456897,0.490566,0,27,0,1394,0.333333
PauloSi85163954,PauloSi85163954,,0,2,2,0,2,2,1,1,1,0,125,0,1395,0.5
MoniqueSinai,MoniqueSinai,,0,1,1,0,1,1,1,1,1,0,96,63,1397,0
imprensacff,imprensacff,,1,0,1,1,0,1,0,0,0,0,96,63,1396,0
IgorRoli,IgorRoli,,0,1,1,0,1,1,1,1,1,0,19,0,1398,0
aambrosio08,aambrosio08,,0,1,1,0,1,1,2,0.571429,0.625,0,5,0,1399,0
79Duarte,79Duarte,,0,2,2,0,2,2,1,1,1,0,125,0,1400,0.5
GilCesar01,GilCesar01,,0,1,1,0,2,2,2,0.545455,0.583333,0,10,0,1401,0
Patty_ms,Patty_ms,,0,1,1,0,1,1,1,1,1,0,97,64,1403,0
unicefbrasil,unicefbrasil,,5,0,5,5,0,5,0,0,0,0,97,64,1402,0
claudioherrera_,claudioherrera_,,0,2,2,0,2,2,1,1,1,0,125,0,1404,0.5
UNVBrasil,UNVBrasil,,0,1,1,0,1,1,1,1,1,0,62,0,1405,0
vitorr82,vitorr82,,0,1,1,0,1,1,1,1,1,0,213,0,1406,0
Lulamariandreia,Lulamariandreia,,0,2,2,0,4,4,2,0.583333,0.642857,0,10,0,1407,0
EsequiasPierre1,EsequiasPierre1,,0,1,1,0,1,1,1,1,1,0,95,62,1408,0
Mario85462000,Mario85462000,,0,1,1,0,1,1,1,1,1,0,98,65,1410,0
berthareynoso,berthareynoso,,1,0,1,1,0,1,0,0,0,0,98,65,1409,0
Perksls,Perksls,,1,0,1,1,0,1,0,0,0,0,92,59,1377,0
5_nelson,5_nelson,,0,1,1,0,1,1,1,1,1,0,99,66,1412,0
MarkMcGowanMP,MarkMcGowanMP,,1,0,1,1,0,1,0,0,0,0,99,66,1411,0
Johnny_Paulo88,Johnny_Paulo88,,0,2,2,0,2,2,1,1,1,0,125,0,1413,0.5
ForaGeno1,ForaGeno1,,0,1,1,0,1,1,2,0.545455,0.583333,0,10,0,1414,0
Artefeedoficial,Artefeedoficial,,2,0,2,2,0,2,0,0,0,0,0,0,244,0
Gerordonez,Gerordonez,,0,1,1,0,2,2,1,1,1,0,29,0,1415,0
falkibets,falkibets,,0,1,1,0,1,1,1,1,1,0,100,67,1417,0
RoyGzz_,RoyGzz_,,1,0,1,1,0,1,0,0,0,0,100,67,1416,0
semujmorenacmx,semujmorenacmx,,0,1,1,0,1,1,1,1,1,0,29,0,1418,0
luna_2610,luna_2610,,0,1,1,0,1,1,1,1,1,0,29,0,1419,0
nandavidall,nandavidall,,0,3,3,0,3,3,4,0.452991,0.487421,0,27,0,1420,0.5
prixx_piu,prixx_piu,,0,1,1,0,1,1,1,1,1,0,101,68,1422,0
ApstStAtanasio,ApstStAtanasio,,1,0,1,1,0,1,0,0,0,0,101,68,1421,0
dalmofs,dalmofs,,0,2,2,0,2,2,1,1,1,0,125,0,1423,0.5
MartinaP_Rendon,MartinaP_Rendon,,0,1,1,0,1,1,1,1,1,0,29,0,1424,0
francis17449596,francis17449596,,0,1,1,0,1,1,1,1,1,0,88,0,1425,0
ura_henrique,ura_henrique,,0,1,1,0,1,1,2,0.571429,0.625,0,5,0,1426,0
Marcio39_,Marcio39_,,1,0,1,1,0,1,0,0,0,0,0,0,243,0
Corsario0609,Corsario0609,,0,1,1,0,1,1,2,0.545455,0.583333,0,10,0,1427,0
VeraRoc55213094,VeraRoc55213094,,0,2,2,0,2,2,1,1,1,0,125,0,1428,0.5
Preguicinha10,Preguicinha10,,0,1,1,0,1,1,2,0.545455,0.583333,0,10,0,1429,0
Lei45Manzani,Lei45Manzani,,0,2,2,0,2,2,1,1,1,0,125,0,1430,0.5
edgarsouza45,edgarsouza45,,0,2,2,0,2,2,1,1,1,0,125,0,1431,0.5
Simone684843551,Simone684843551,,0,2,2,0,2,2,1,1,1,0,125,0,1432,0.5
aline_ben,aline_ben,,0,1,1,0,1,1,1,1,1,0,102,0,1433,0
ctardaguila,ctardaguila,,15,1,16,15,1,16,0,0,0,0,102,0,3,0.066667
mary28653912,mary28653912,,0,1,1,0,1,1,1,1,1,0,103,69,1435,0
Dario_Kopenawa,Dario_Kopenawa,,3,0,3,3,0,3,0,0,0,0,103,69,1434,0
cecicampos0577,cecicampos0577,,0,2,2,0,2,2,1,1,1,0,125,0,1436,0.5
Analima_alef,Analima_alef,,0,5,5,0,5,5,2,0.666667,0.75,0,213,0,1439,0
conexaoplaneta,conexaoplaneta,,1,0,1,1,0,1,0,0,0,0,213,0,1438,0
esquerdize,esquerdize,,0,1,1,0,1,1,2,0.545455,0.583333,0,10,0,1440,0
BoleirosReserva,BoleirosReserva,,0,1,1,0,1,1,1,1,1,0,104,70,1442,0
Boleirosnet,Boleirosnet,,2,0,2,2,0,2,0,0,0,0,104,70,1441,0
palmeiraszip,palmeiraszip,,0,1,1,0,1,1,1,1,1,0,104,70,1443,0
PauloRicadobs,PauloRicadobs,,0,1,1,0,1,1,1,1,1,0,105,71,1445,0
FofisLu,FofisLu,,3,0,3,3,0,3,0,0,0,0,105,71,1444,0
MSinarinha,MSinarinha,,0,1,1,0,3,3,2,0.545455,0.583333,0,10,0,1446,0
Santa13Moreira,Santa13Moreira,,0,2,2,0,2,2,1,1,1,0,125,0,1447,0.5
junioralencar05,junioralencar05,,0,2,2,0,2,2,1,1,1,0,125,0,1448,0.5
tamiekaran,tamiekaran,,0,1,1,0,2,2,1,1,1,0,76,0,1449,0
bbvb2011,bbvb2011,,0,3,3,0,3,3,5,0.308438,0.323637,0,45,0,1450,0.333333
DaltoJmb,DaltoJmb,,2,22,24,2,32,34,4,0.443357,0.481861,0.000016,45,0,315,0.023715
bemestar,bemestar,,2,0,2,2,0,2,0,0,0,0,45,0,207,0.5
tvglobo,tvglobo,,2,0,2,3,0,3,0,0,0,0,45,0,206,0.5
alberto_quadros,alberto_quadros,,0,2,2,0,2,2,1,1,1,0,125,0,1451,0.5
ifernandotorres,ifernandotorres,,0,2,2,0,2,2,1,1,1,0,125,0,1452,0.5
LimpiCelia,LimpiCelia,,0,2,2,0,2,2,1,1,1,0,125,0,1453,0.5
NormandoRios4,NormandoRios4,,0,3,3,0,4,4,3,0.448276,0.538462,0,4,0,1455,0.166667
drauziovarella,drauziovarella,,6,0,6,6,0,6,0,0,0,0,4,0,1454,0
SF_Moro,SF_Moro,,3,0,3,8,0,8,0,0,0,0,45,0,50,0.5
carmenrios,carmenrios,,0,2,2,0,2,2,1,1,1,0,125,0,1456,0.5
raphaellferraz,raphaellferraz,,0,2,2,0,2,2,1,1,1,0,125,0,1457,0.5
MariaVa14959703,MariaVa14959703,,0,1,1,0,9,9,2,0.545455,0.583333,0,10,0,1458,0
doriadeferro,doriadeferro,,0,2,2,0,2,2,1,1,1,0,125,0,1459,0.5
CarolLorusso,CarolLorusso,,0,2,2,0,2,2,1,1,1,0,125,0,1460,0.5
andre_barcinski,andre_barcinski,,1,0,1,2,0,2,0,0,0,0,27,0,93,0
JonasMe28123662,JonasMe28123662,,0,2,2,0,2,2,1,1,1,0,125,0,1461,0.5
abomfim65,abomfim65,,0,2,2,0,2,2,1,1,1,0,125,0,1462,0.5
crowleyonce,crowleyonce,,0,1,1,0,1,1,2,0.545455,0.583333,0,10,0,1463,0
carlosmadeiro,carlosmadeiro,,1,0,1,10,0,10,0,0,0,0,27,0,92,0
OnockoRosana,OnockoRosana,,1,0,1,10,0,10,0,0,0,0,27,0,89,0
ligiakerr,ligiakerr,,1,0,1,10,0,10,0,0,0,0,27,0,88,0
julilouzada,julilouzada,,0,1,1,0,1,1,1,1,1,0,5,0,1464,0
MariaJosPinhei5,MariaJosPinhei5,,0,1,1,0,1,1,2,0.666667,0.75,0,76,0,1465,0
francineidelop7,francineidelop7,,0,2,2,0,2,2,1,1,1,0,125,0,1466,0.5
thomaziniale,thomaziniale,,0,1,1,0,1,1,2,0.545455,0.583333,0,10,0,1467,0
naderjaafar8,naderjaafar8,,0,4,4,0,6,6,2,0.666667,0.75,0,10,0,1468,0.25
MaikeMC2001,MaikeMC2001,,0,2,2,0,2,2,1,1,1,0,125,0,1469,0.5
micalarei,micalarei,,0,1,1,0,1,1,2,0.571429,0.625,0,5,0,1470,0
LongoWaleria,LongoWaleria,,0,2,2,0,2,2,1,1,1,0,125,0,1471,0.5
Filipep15,Filipep15,,0,2,2,0,2,2,1,1,1,0,125,0,1472,0.5
Roberto72402949,Roberto72402949,,0,1,1,0,1,1,1,1,1,0,5,0,1473,0
DGBensina,DGBensina,,8,0,8,8,0,8,0,0,0,0,5,0,711,0
soobser47710052,soobser47710052,,0,2,2,0,8,8,2,0.583333,0.642857,0,10,0,1474,0
TomBDph,TomBDph,,0,1,1,0,1,1,2,0.545455,0.583333,0,10,0,1475,0
DataTweet7,DataTweet7,,0,1,1,0,3,3,1,1,1,0,5,0,1476,0
CeliaMota8,CeliaMota8,,0,1,1,0,1,1,1,1,1,0,10,0,1477,0
maolire,maolire,,0,2,2,0,2,2,2,0.583333,0.642857,0,88,0,1478,0
palas_athenada,palas_athenada,,0,1,1,0,1,1,1,1,1,0,19,0,1479,0
OKenays,OKenays,,0,1,1,0,1,1,2,0.545455,0.583333,0,10,0,1480,0
clagraca,clagraca,,0,1,1,0,4,4,2,0.545455,0.583333,0,10,0,1481,0
twnelsongn,twnelsongn,,0,1,1,0,1,1,2,0.545455,0.583333,0,10,0,1482,0
jomirofi,jomirofi,,0,2,2,0,2,2,1,1,1,0,125,0,1483,0.5
heliopaz,heliopaz,,0,3,3,0,4,4,4,0.464912,0.496855,0,27,0,1484,0.333333
ShSilSam80,ShSilSam80,,0,1,1,0,3,3,2,0.545455,0.583333,0,10,0,1485,0
PedroHLacer,PedroHLacer,,0,1,1,0,1,1,2,0.545455,0.583333,0,10,0,1486,0
mlnsntn,mlnsntn,,0,1,1,0,1,1,2,0.545455,0.583333,0,10,0,1487,0
saindodoTcansei,saindodoTcansei,,0,1,1,0,1,1,2,0.545455,0.583333,0,10,0,1488,0
henrique_jmo,henrique_jmo,,0,4,4,0,9,9,2,0.666667,0.75,0,10,0,1489,0.25
DougPereiraAdv,DougPereiraAdv,,0,1,1,0,1,1,1,1,1,0,5,0,1490,0
tbsossai,tbsossai,,0,1,1,0,1,1,1,1,1,0,213,0,1491,0
carloslima_sp,carloslima_sp,,0,2,2,0,2,2,1,1,1,0,125,0,1492,0.5
WalterElizondo,WalterElizondo,,0,1,1,0,1,1,1,1,1,0,29,0,1493,0
CabralEanes,CabralEanes,,0,1,1,0,1,1,2,0.571429,0.625,0,5,0,1494,0
tv_varella,tv_varella,,0,2,2,0,2,2,1,1,1,0,125,0,1495,0.5
CoradoCamara,CoradoCamara,,0,2,2,0,2,2,1,1,1,0,125,0,1496,0.5
AnsaldiSamantha,AnsaldiSamantha,,0,2,2,0,2,2,1,1,1,0,125,0,1497,0.5
FerreiraVamor,FerreiraVamor,,0,2,2,0,2,2,1,1,1,0,125,0,1498,0.5
Fe_RMoreira,Fe_RMoreira,,0,1,1,0,1,1,1,1,1,0,19,0,1499,0
PelleJons1,PelleJons1,,0,5,5,0,5,5,4,0.46281,0.505952,0,27,0,1500,0.15
xmoritinhax,xmoritinhax,,0,3,3,0,3,3,4,0.452991,0.487421,0,27,0,1501,0.5
GUMERCINDOFJ,GUMERCINDOFJ,,0,2,2,0,2,2,1,1,1,0,125,0,1502,0.5
idemjerry,idemjerry,,0,1,1,0,1,1,1,1,1,0,19,0,1503,0
renata_capucci,renata_capucci,,0,1,1,0,1,1,1,1,1,0,19,0,1504,0
claudiaplanis,claudiaplanis,,0,1,1,0,1,1,1,1,1,0,213,0,1505,0
john_allas,john_allas,,0,1,1,0,1,1,1,1,1,0,10,0,1506,0
marcosnetoadv,marcosnetoadv,,0,2,2,0,2,2,1,1,1,0,125,0,1507,0.5
DrGustavoOlive2,DrGustavoOlive2,,0,1,1,0,1,1,1,1,1,0,10,0,1508,0
Lucier96025171,Lucier96025171,,0,1,1,0,2,2,2,0.571429,0.625,0,5,0,1509,0
sunshineijun,sunshineijun,,0,1,1,0,1,1,1,1,1,0,10,0,1510,0
BrazilOfCards,BrazilOfCards,,0,1,1,0,3,3,2,0.6,0.666667,0,62,0,1511,0
daniel77gomes,daniel77gomes,,0,1,1,0,1,1,1,1,1,0,10,0,1512,0
prog_brasil,prog_brasil,,1,0,1,1,0,1,0,0,0,0,10,0,374,0
Iram90213200,Iram90213200,,0,1,1,0,1,1,1,1,1,0,10,0,1513,0
presshubbr,presshubbr,,0,2,2,0,2,2,1,1,1,0,162,0,1515,0
WanderJSZ,WanderJSZ,,0,1,1,0,1,1,2,0.545455,0.583333,0,10,0,1516,0
nandobeibinho,nandobeibinho,,0,1,1,0,1,1,1,1,1,0,10,0,1517,0
P2Dutra,P2Dutra,,0,2,2,0,2,2,1,1,1,0,125,0,1518,0.5
mnzmda,mnzmda,,0,1,1,0,1,1,1,1,1,0,10,0,1519,0
terezasilva61,terezasilva61,,0,1,1,0,1,1,1,1,1,0,80,0,1520,0
areavip,areavip,,2,0,2,2,0,2,0,0,0,0,80,0,1224,0
bereQuints,bereQuints,,0,1,1,0,1,1,1,1,1,0,10,0,1521,0
gasseruto,gasseruto,,0,1,1,0,1,1,1,1,1,0,10,0,1522,0
maybimxk,maybimxk,,2,0,2,2,0,2,0,0,0,0,0,0,242,0
gutto_Belo,gutto_Belo,,0,1,1,0,1,1,1,1,1,0,10,0,1523,0
leo_silva_0,leo_silva_0,,0,1,1,0,1,1,1,1,1,0,10,0,1524,0
Kbid83,Kbid83,,0,3,3,0,11,11,2,0.636364,0.714286,0,10,0,1525,0.166667
Rosagath,Rosagath,,0,1,1,0,2,2,2,0.545455,0.583333,0,10,0,1526,0
dnpsp11,dnpsp11,,0,1,1,0,1,1,1,1,1,0,10,0,1527,0
AlessandreReis3,AlessandreReis3,,0,1,1,0,1,1,2,0.571429,0.625,0,5,0,1528,0
tommyberesford,tommyberesford,,0,2,2,0,2,2,1,1,1,0,19,0,1529,0
T_Cordeiro99,T_Cordeiro99,,0,1,1,0,1,1,2,0.571429,0.625,0,5,0,1530,0
xandinhamc,xandinhamc,,0,2,2,0,4,4,3,0.515152,0.54902,0,10,0,1531,0
Cor83634376Jp,Cor83634376Jp,,0,1,1,0,1,1,2,0.538462,0.571429,0,31,0,1538,0
dEArchi_tect,dEArchi_tect,,2,6,8,2,6,8,1,1,1,0.000001,31,0,1537,0
EdsonPinheiro10,EdsonPinheiro10,,0,2,2,0,2,2,1,1,1,0,125,0,1539,0.5
Jaqueli03166262,Jaqueli03166262,,0,2,2,0,2,2,3,0.466667,0.571429,0,27,0,1541,0
alcarsil,alcarsil,,2,1,3,2,1,3,0,0,0,0,27,0,1540,0.5
badgirldell,badgirldell,,0,1,1,0,1,1,2,0.545455,0.583333,0,10,0,1542,0
versao_black,versao_black,,0,1,1,0,1,1,1,1,1,0,41,0,1543,0
muitoflow,muitoflow,,0,1,1,0,1,1,1,1,1,0,10,0,1544,0
RickyYatsunaga,RickyYatsunaga,,1,0,1,1,0,1,0,0,0,0,0,0,241,0
MundoEmanuel4,MundoEmanuel4,,0,1,1,0,1,1,1,1,1,0,69,43,1545,0
MarcosMilagre,MarcosMilagre,,0,1,1,0,1,1,1,1,1,0,19,0,1546,0
Paulobatatando,Paulobatatando,,0,1,1,0,1,1,1,1,1,0,106,72,1548,0
magdasueli2,magdasueli2,,1,0,1,1,0,1,0,0,0,0,106,72,1547,0
letrasmari,letrasmari,,0,1,1,0,4,4,2,0.545455,0.583333,0,10,0,1549,0
widmer_michel,widmer_michel,,0,1,1,0,1,1,1,1,1,0,107,73,1551,0
VictorCostaLuta,VictorCostaLuta,,1,0,1,1,0,1,0,0,0,0,107,73,1550,0
drdantediaz,drdantediaz,,0,1,1,0,1,1,3,0.5,0.530303,0,19,0,1552,0
OhDearMarkF,OhDearMarkF,,0,2,2,0,2,2,1,1,1,0,125,0,1553,0.5
EduardoSuccini,EduardoSuccini,,1,0,1,1,0,1,0,0,0,0,10,0,370,0
CamisaNoControl,CamisaNoControl,,0,1,1,0,2,2,1,1,1,0,88,0,1554,0
qquell,qquell,,2,0,2,2,0,2,0,0,0,0,10,0,240,0
PalomaPiragibe,PalomaPiragibe,,0,1,1,0,1,1,1,1,1,0,19,0,1555,0
JACKPRAIA,JACKPRAIA,,0,1,1,0,1,1,1,1,1,0,213,0,1556,0
victorhguima,victorhguima,,0,2,2,0,2,2,1,1,1,0,125,0,1557,0.5
Gabriel67880419,Gabriel67880419,,0,1,1,0,6,6,1,1,1,0,88,0,1558,0
Augusto74634111,Augusto74634111,,0,3,3,0,3,3,2,0.615385,0.6875,0,76,0,1559,0.333333
afandrioli1964,afandrioli1964,,0,2,2,0,2,2,1,1,1,0,125,0,1560,0.5
gidiane_nunes,gidiane_nunes,,0,1,1,0,1,1,1,1,1,0,0,0,1561,0
fiverivers86,fiverivers86,,0,2,2,0,2,2,1,1,1,0,125,0,1562,0.5
pabloangel_19,pabloangel_19,,0,1,1,0,1,1,1,1,1,0,29,0,1563,0
Zaca59744573,Zaca59744573,,0,2,2,0,2,2,1,1,1,0,125,0,1564,0.5
aiaiai63,aiaiai63,,0,1,1,0,1,1,1,1,1,0,213,0,1565,0
Alexmacsouza,Alexmacsouza,,0,2,2,0,2,2,1,1,1,0,125,0,1566,0.5
Leila_Argollo,Leila_Argollo,,0,1,1,0,1,1,1,1,1,0,213,0,1567,0
LFragaSantAnna,LFragaSantAnna,,0,4,4,0,4,4,2,0.642857,0.722222,0,76,0,1569,0.166667
alpha_2010,alpha_2010,,0,1,1,0,2,2,1,1,1,0,29,0,1570,0
bund4comenta,bund4comenta,,0,1,1,0,1,1,2,0.6,0.666667,0,62,0,1571,0
victorhlmd1,victorhlmd1,,0,1,1,0,1,1,1,1,1,0,29,0,1572,0
ligur_,ligur_,,0,1,1,0,1,1,2,0.545455,0.583333,0,10,0,1573,0
lchaves1988,lchaves1988,,0,1,1,0,1,1,3,0.413793,0.458333,0,4,0,1574,0
SorDaniel,SorDaniel,,0,1,1,0,2,2,1,1,1,0,19,0,1575,0
Lula_Tavares,Lula_Tavares,,0,1,1,0,3,3,2,0.545455,0.583333,0,10,0,1576,0
ADRIANADEOLIV49,ADRIANADEOLIV49,,0,1,1,0,1,1,2,0.545455,0.583333,0,10,0,1577,0
eumateus75,eumateus75,,0,2,2,0,2,2,2,0.583333,0.642857,0,213,0,1578,0
rodrigo_m_arati,rodrigo_m_arati,,0,9,9,0,24,24,3,0.514563,0.566038,0,10,0,1579,0.319444
YamautiCarmen,YamautiCarmen,,0,2,2,0,2,2,1,1,1,0,125,0,1580,0.5
ramonsl,ramonsl,,0,1,1,0,3,3,1,1,1,0,19,0,1581,0
AnaLima191287,AnaLima191287,,0,2,2,0,2,2,1,1,1,0,125,0,1582,0.5
tiaJuPires,tiaJuPires,,0,1,1,0,1,1,1,1,1,0,19,0,1583,0
Cleo135,Cleo135,,0,1,1,0,1,1,1,1,1,0,19,0,1584,0
Nilzasousa8,Nilzasousa8,,0,1,1,0,1,1,1,1,1,0,19,0,1585,0
AntonioFaroJr76,AntonioFaroJr76,,0,2,2,0,3,3,1,1,1,0,108,74,1588,0
paularibeiroc,paularibeiroc,,2,0,2,4,0,4,0,0,0,0,108,74,1587,0
Decolar,Decolar,,2,0,2,2,0,2,0,0,0,0,108,74,1586,0
COVIDLive,COVIDLive,,1,0,1,1,0,1,0,0,0,0,0,0,239,0
chegueinaarea,chegueinaarea,,0,1,1,0,1,1,1,1,1,0,19,0,1589,0
cha_kramer,cha_kramer,,0,1,1,0,1,1,1,1,1,0,19,0,1590,0
AndreMarianoRi1,AndreMarianoRi1,,0,1,1,0,1,1,1,1,1,0,213,0,1591,0
carlarangel1,carlarangel1,,0,1,1,0,2,2,1,1,1,0,19,0,1592,0
FaroJr4,FaroJr4,,0,2,2,0,3,3,1,1,1,0,108,74,1593,0
rensi_antonio,rensi_antonio,,0,1,1,0,2,2,2,0.545455,0.583333,0,10,0,1594,0
MariaCr35384827,MariaCr35384827,,0,2,2,0,2,2,1,1,1,0,125,0,1595,0.5
professoraKathi,professoraKathi,,0,2,2,0,2,2,1,1,1,0,125,0,1596,0.5
PauloAlves2037,PauloAlves2037,,0,1,1,0,1,1,1,1,1,0,10,0,1597,0
profcardoso,profcardoso,,0,2,2,0,2,2,1,1,1,0,125,0,1598,0.5
LuizCar20454634,LuizCar20454634,,0,1,1,0,1,1,2,0.545455,0.583333,0,10,0,1599,0
zunzoom,zunzoom,,0,1,1,0,1,1,1,1,1,0,10,0,1600,0
Brunosouza25,Brunosouza25,,0,1,1,0,1,1,1,1,1,0,19,0,1601,0
portalgp1,portalgp1,,0,1,1,0,6,6,1,1,1,0,1,1,1602,0
Home_phone_ET,Home_phone_ET,,0,1,1,0,1,1,1,1,1,0,19,0,1603,0
buca_conway,buca_conway,,0,1,1,0,1,1,1,1,1,0,10,0,1604,0
AntonioCCdaCun1,AntonioCCdaCun1,,0,1,1,0,1,1,1,1,1,0,19,0,1605,0
casfamili,casfamili,,0,2,2,0,2,2,1,1,1,0,125,0,1606,0.5
bahmiguel,bahmiguel,,0,1,1,0,1,1,1,1,1,0,10,0,1607,0
Marceli87052649,Marceli87052649,,0,3,3,0,6,6,1,1,1,0,76,0,1608,0.333333
fernandocabfr71,fernandocabfr71,,0,1,1,0,1,1,2,0.6,0.666667,0,62,0,1609,0
maisribatejo,maisribatejo,,1,0,1,1,0,1,0,0,0,0,10,0,369,0
LeiLoc13,LeiLoc13,,0,1,1,0,1,1,1,1,1,0,10,0,1610,0
JoaoRicardoCor1,JoaoRicardoCor1,,0,1,1,0,1,1,1,1,1,0,88,0,1611,0
joao_fidalgo,joao_fidalgo,,0,1,1,0,1,1,2,0.545455,0.583333,0,10,0,1612,0
PinaAdemir,PinaAdemir,,0,3,3,0,4,4,1,1,1,0,45,0,1616,0
BlaugranaNeves,BlaugranaNeves,,1,0,1,1,0,1,0,0,0,0,45,0,1615,0
BolsonaroSP,BolsonaroSP,,2,0,2,3,0,3,0,0,0,0,45,0,1614,0
AnaMari56782081,AnaMari56782081,,0,1,1,0,1,1,2,0.545455,0.583333,0,10,0,1617,0
mattcorradi,mattcorradi,,0,2,2,0,2,2,1,1,1,0,125,0,1618,0.5
Ana_Navarrete,Ana_Navarrete,,0,1,1,0,1,1,1,1,1,0,5,0,1619,0
GTPI,GTPI,,4,0,4,4,0,4,0,0,0,0,5,0,511,0
MariaConceioF20,MariaConceioF20,,1,0,1,1,0,1,0,0,0,0,45,0,1613,0
AiltonPrince,AiltonPrince,,0,1,1,0,1,1,1,1,1,0,125,0,1620,0
ConassOficial,ConassOficial,,12,0,12,12,0,12,0,0,0,0,125,0,77,0
joaovitorbt,joaovitorbt,,0,1,1,0,1,1,1,1,1,0,88,0,1621,0
zenoncarvalho1,zenoncarvalho1,,0,2,2,0,2,2,1,1,1,0,125,0,1622,0.5
wagn_am,wagn_am,,0,1,1,0,1,1,1,1,1,0,62,0,1623,0
hobbit_coisado,hobbit_coisado,,0,1,1,0,1,1,2,0.545455,0.583333,0,10,0,1624,0
GePortoLucerina,GePortoLucerina,,0,1,1,0,1,1,1,1,1,0,41,0,1625,0
Teresa_Crystyna,Teresa_Crystyna,,0,1,1,0,3,3,2,0.545455,0.583333,0,10,0,1626,0
ex_tiozao_do_di,ex_tiozao_do_di,,0,2,2,0,2,2,1,1,1,0,125,0,1627,0.5
brachoditrevi,brachoditrevi,,0,3,3,0,4,4,1,1,1,0,41,0,1628,0
ChanYiang,ChanYiang,,3,0,3,5,0,5,0,0,0,0,5,0,225,0
MariaAngelsp,MariaAngelsp,,0,1,1,0,1,1,1,1,1,0,41,0,1629,0
luca_nery,luca_nery,,1,0,1,1,0,1,0,0,0,0,66,0,759,0
esmuellert_,esmuellert_,,1,0,1,1,0,1,0,0,0,0,31,0,1536,0
PaulaNaLua,PaulaNaLua,,0,1,1,0,1,1,1,1,1,0,41,0,1630,0
MaruxdoPT,MaruxdoPT,,0,1,1,0,1,1,2,0.545455,0.583333,0,10,0,1631,0
FelipeDOPT,FelipeDOPT,,0,1,1,0,4,4,2,0.545455,0.583333,0,10,0,1632,0
BattelAlexandre,BattelAlexandre,,0,2,2,0,2,2,1,1,1,0,125,0,1633,0.5
michel_dennis,michel_dennis,,0,2,2,0,2,2,1,1,1,0,125,0,1634,0.5
agoranoticiasbr,agoranoticiasbr,,14,1,15,18,1,19,0,0,0,0,50,0,327,0.071429
odio_nao,odio_nao,,0,7,7,0,9,9,2,0.684211,0.769231,0,115,0,1635,0.071429
afonsoborges,afonsoborges,,3,1,4,3,1,4,1,1,1,0,115,0,5,0
marcodor,marcodor,,0,1,1,0,1,1,1,1,1,0,109,75,1637,0
EddieZatto,EddieZatto,,1,0,1,1,0,1,0,0,0,0,109,75,1636,0
LuccaScaranello,LuccaScaranello,,0,2,2,0,2,2,1,1,1,0,125,0,1638,0.5
margogrimberg,margogrimberg,,0,2,2,0,2,2,1,1,1,0,125,0,1639,0.5
BiasotoMioto,BiasotoMioto,,0,2,2,0,2,2,1,1,1,0,125,0,1640,0.5
Nelifaria,Nelifaria,,0,2,2,0,2,2,1,1,1,0,125,0,1641,0.5
Jonathan_Tank,Jonathan_Tank,,0,1,1,0,3,3,2,0.6,0.666667,0,62,0,1642,0
Coraz0nDeLe0n,Coraz0nDeLe0n,,0,1,1,0,1,1,1,1,1,0,76,0,1643,0
CamillaSaporito,CamillaSaporito,,1,1,2,1,1,2,1,1,1,0,110,76,1645,0.5
BRGenshinImpact,BRGenshinImpact,,2,0,2,2,0,2,0,0,0,0,110,76,1644,0.5
CICV_br,CICV_br,,5,0,5,5,0,5,0,0,0,0,5,0,238,0
henrichschagas,henrichschagas,,0,1,1,0,1,1,2,0.545455,0.583333,0,10,0,1646,0
GuiCoiradas,GuiCoiradas,,0,2,2,0,2,2,1,1,1,0,125,0,1647,0.5
821Claudia,821Claudia,,0,3,3,0,3,3,2,0.615385,0.6875,0,76,0,1648,0.333333
aarusso_nyx,aarusso_nyx,,0,2,2,0,2,2,1,1,1,0,125,0,1649,0.5
Rosemir74980913,Rosemir74980913,,0,2,2,0,2,2,1,1,1,0,125,0,1650,0.5
MarcosVoteCiro,MarcosVoteCiro,,0,1,1,0,1,1,1,1,1,0,105,71,1651,0
alciopitt2,alciopitt2,,0,2,2,0,2,2,1,1,1,0,125,0,1652,0.5
arretada13,arretada13,,0,1,1,0,1,1,2,0.545455,0.583333,0,10,0,1653,0
PauloRe24254775,PauloRe24254775,,0,1,1,0,1,1,1,1,1,0,105,71,1654,0
crisbelcortes,crisbelcortes,,0,2,2,0,2,2,1,1,1,0,125,0,1655,0.5
AFPBrasil,AFPBrasil,,0,2,2,0,5,5,2,0.666667,0.75,0,62,0,1656,0
magdainez,magdainez,,0,1,1,0,1,1,2,0.545455,0.583333,0,10,0,1657,0
fredpn8,fredpn8,,0,1,1,0,1,1,1,1,1,0,103,69,1658,0
Visao_pt,Visao_pt,,2,0,2,2,0,2,0,0,0,0,10,0,368,0
SoraiaSampaio3,SoraiaSampaio3,,0,1,1,0,1,1,1,1,1,0,10,0,1659,0
Horus_Braga,Horus_Braga,,0,2,2,0,2,2,1,1,1,0,125,0,1660,0.5
simonecostabrez,simonecostabrez,,0,4,4,0,6,6,2,0.625,0.7,0,62,0,1661,0.083333
mirovisk31,mirovisk31,,0,2,2,0,2,2,1,1,1,0,125,0,1662,0.5
AbramoMiriam,AbramoMiriam,,0,2,2,0,2,2,1,1,1,0,125,0,1663,0.5
horanaravs,horanaravs,,0,1,1,0,1,1,2,0.666667,0.75,0,0,0,1664,0
MrMMarsh,MrMMarsh,,1,0,1,1,0,1,0,0,0,0,27,0,1282,0
TheSkepticMag,TheSkepticMag,,1,0,1,1,0,1,0,0,0,0,27,0,1281,0
BrasileiroEm,BrasileiroEm,,0,1,1,0,1,1,2,0.545455,0.583333,0,10,0,1665,0
DeniseKD,DeniseKD,,0,1,1,0,1,1,1,1,1,0,125,0,1666,0
Aribueno10,Aribueno10,,0,2,2,0,2,2,1,1,1,0,125,0,1667,0.5
PedroAntnioNob1,PedroAntnioNob1,,0,2,2,0,2,2,1,1,1,0,125,0,1668,0.5
LoboTeresinha,LoboTeresinha,,0,1,1,0,1,1,2,0.545455,0.583333,0,10,0,1669,0
ErikaBB,ErikaBB,,0,2,2,0,2,2,1,1,1,0,125,0,1670,0.5
BrasilVeritas,BrasilVeritas,,0,3,3,0,3,3,1,1,1,0,125,0,1672,0
Alma_Preta,Alma_Preta,,1,0,1,1,0,1,0,0,0,0,125,0,1671,0
Nilsonredis,Nilsonredis,,0,2,2,0,2,2,1,1,1,0,125,0,1673,0.5
Vika8081,Vika8081,,0,2,2,0,2,2,1,1,1,0,125,0,1674,0.5
LatAmJornalismo,LatAmJornalismo,,0,2,2,0,2,2,1,1,1,0,111,77,1677,0
KnightCenterUT,KnightCenterUT,,1,0,1,1,0,1,0,0,0,0,111,77,1676,0
UNESCO,UNESCO,,1,0,1,1,0,1,0,0,0,0,111,77,1675,0
Bloquear6,Bloquear6,,0,2,2,0,2,2,1,1,1,0,125,0,1678,0.5
Ricardo91526789,Ricardo91526789,,0,1,1,0,1,1,2,0.571429,0.625,0,94,61,1679,0
OrgunDetonator,OrgunDetonator,,0,2,2,0,2,2,1,1,1,0,125,0,1680,0.5
tiagoooliveira,tiagoooliveira,,0,2,2,0,2,2,1,1,1,0,125,0,1681,0.5
LionHeartRicard,LionHeartRicard,,0,2,2,0,4,4,2,0.583333,0.642857,0,10,0,1682,0
RitaLaide,RitaLaide,,0,2,2,0,2,2,1,1,1,0,125,0,1683,0.5
dariosaadi,dariosaadi,,1,0,1,2,0,2,0,0,0,0,94,61,1384,0
RAUDIRAUDI,RAUDIRAUDI,,0,1,1,0,1,1,1,1,1,0,5,0,1684,0
frassad,frassad,,0,2,2,0,2,2,1,1,1,0,125,0,1685,0.5
mazinhonegrao,mazinhonegrao,,0,2,2,0,2,2,1,1,1,0,125,0,1686,0.5
MariaLCAb,MariaLCAb,,0,4,4,0,4,4,1,1,1,0,125,0,1687,0.083333
EliTole1,EliTole1,,0,1,1,0,2,2,2,0.545455,0.583333,0,10,0,1688,0
UNIAO45,UNIAO45,,0,2,2,0,2,2,1,1,1,0,125,0,1689,0.5
laercioqhotmai1,laercioqhotmai1,,0,1,1,0,1,1,2,0.545455,0.583333,0,10,0,1690,0
ElianadaCruzRo1,ElianadaCruzRo1,,0,1,1,0,9,9,2,0.545455,0.583333,0,10,0,1691,0
fabi1803,fabi1803,,0,2,2,0,2,2,1,1,1,0,125,0,1692,0.5
batistasjdor,batistasjdor,,0,2,2,0,2,2,1,1,1,0,125,0,1693,0.5
guilhewrme_,guilhewrme_,,0,2,2,0,4,4,2,0.583333,0.642857,0,10,0,1694,0
marcelinothe1st,marcelinothe1st,,0,2,2,0,2,2,1,1,1,0,125,0,1695,0.5
zehdeabreu,zehdeabreu,,0,1,1,0,1,1,2,0.545455,0.583333,0,10,0,1696,0
erejonson,erejonson,,0,1,1,0,1,1,2,0.545455,0.583333,0,10,0,1697,0
Alezan03360487,Alezan03360487,,0,1,1,0,1,1,2,0.545455,0.583333,0,10,0,1698,0
detetivevsilva,detetivevsilva,,0,6,6,0,8,8,3,0.5,0.537736,0,27,0,1699,0.333333
LeadsHibiscus,LeadsHibiscus,,1,1,2,1,1,2,0,0,0,0,112,78,1700,0
claitonline44,claitonline44,,0,4,4,0,5,5,2,0.7,0.785714,0,76,0,1701,0.166667
patriciosafe,patriciosafe,,0,1,1,0,1,1,1,1,1,0,113,79,1703,0
Com_CHUO,Com_CHUO,,1,0,1,1,0,1,0,0,0,0,113,79,1702,0
duterv,duterv,,0,2,2,0,2,2,1,1,1,0,125,0,1704,0.5
FutebolBr_Norte,FutebolBr_Norte,,0,1,1,0,1,1,1,1,1,0,114,80,1706,0
saoraimundoec,saoraimundoec,,1,0,1,1,0,1,0,0,0,0,114,80,1705,0
MarciaLatifi,MarciaLatifi,,0,1,1,0,3,3,2,0.545455,0.583333,0,10,0,1707,0
edisenra,edisenra,,0,1,1,0,1,1,2,0.666667,0.75,0,115,0,1708,0
jnascim,jnascim,,28,1,29,29,1,30,1,1,1,0,115,0,344,0.03202
carlosolivrnt,carlosolivrnt,,0,2,2,0,2,2,1,1,1,0,125,0,1709,0.5
DoriaDoVigor,DoriaDoVigor,,0,2,2,0,2,2,1,1,1,0,125,0,1710,0.5
lccosta26,lccosta26,,0,2,2,0,2,2,1,1,1,0,125,0,1711,0.5
AmeliaBolsonaro,AmeliaBolsonaro,,1,13,14,2,16,18,2,0.933333,0.964286,0.000001,0,0,236,0.010989
recambero,recambero,,0,2,2,0,2,2,1,1,1,0,125,0,1712,0.5
NetoBB,NetoBB,,0,2,2,0,2,2,1,1,1,0,125,0,1713,0.5
lucianaroccaaa,lucianaroccaaa,,0,2,2,0,2,2,1,1,1,0,125,0,1714,0.5
rtfranceschi,rtfranceschi,,0,3,3,0,3,3,2,0.615385,0.6875,0,125,0,1715,0.166667
iJoaooo,iJoaooo,,0,2,2,0,2,2,1,1,1,0,125,0,1716,0.5
AndreFJGoncalve,AndreFJGoncalve,,1,0,1,1,0,1,0,0,0,0,5,0,712,0
AlexLumen,AlexLumen,,0,1,1,0,1,1,1,1,1,0,0,0,1717,0
unidospelavida,unidospelavida,,3,0,3,3,0,3,0,0,0,0,0,0,216,0
rosangela_2018,rosangela_2018,,0,3,3,0,3,3,2,0.615385,0.6875,0,125,0,1718,0.166667
rosangela_bolze,rosangela_bolze,,0,3,3,0,3,3,1,1,1,0,125,0,1719,0.166667
JuliaSchucht,JuliaSchucht,,0,1,1,0,3,3,2,0.545455,0.583333,0,10,0,1720,0
BrunoMa29787574,BrunoMa29787574,,0,2,2,0,2,2,1,1,1,0,125,0,1721,0.5
marcioce2036,marcioce2036,,0,2,2,0,2,2,1,1,1,0,125,0,1722,0.5
mausantos45,mausantos45,,1,3,4,1,3,4,1,1,1,0,45,0,1723,0.333333
VITOWSKI40,VITOWSKI40,,0,1,1,0,1,1,1,1,1,0,116,81,1725,0
WendellSousaa,WendellSousaa,,1,0,1,1,0,1,0,0,0,0,116,81,1724,0
AleatoryGabs,AleatoryGabs,,0,2,2,0,2,2,1,1,1,0,125,0,1726,0.5
Jacyra1980,Jacyra1980,,0,2,2,0,2,2,1,1,1,0,117,82,1729,0.5
OtvioMendona4,OtvioMendona4,,1,1,2,1,1,2,1,1,1,0,117,82,1728,0.5
lf_araujo,lf_araujo,,2,0,2,2,0,2,0,0,0,0,117,82,1727,0.5
Redelab_pt,Redelab_pt,,0,2,2,0,2,2,2,0.75,0.833333,0,8,0,1730,0.5
rhayabne,rhayabne,,0,1,1,0,1,1,1,1,1,0,97,64,1731,0
pallasgoddess,pallasgoddess,,0,1,1,0,1,1,1,1,1,0,5,0,1732,0
gercimonteiro,gercimonteiro,,0,2,2,0,2,2,1,1,1,0,125,0,1733,0.5
BrunoMa44328446,BrunoMa44328446,,0,2,2,0,2,2,1,1,1,0,125,0,1734,0.5
noahshuster,noahshuster,,0,2,2,0,2,2,1,1,1,0,125,0,1735,0.5
Zaga_Silos,Zaga_Silos,,0,2,2,0,2,2,1,1,1,0,125,0,1736,0.5
Ary_AntiPT,Ary_AntiPT,,0,2,2,0,2,2,1,1,1,0,125,0,1737,0.5
SistemaAnt,SistemaAnt,,0,1,1,0,1,1,1,1,1,0,5,0,1738,0
RadomHistory,RadomHistory,,0,2,2,0,2,2,1,1,1,0,125,0,1739,0.5
ainistar,ainistar,,0,1,1,0,2,2,2,0.545455,0.583333,0,10,0,1740,0
AndreaP56816373,AndreaP56816373,,0,3,3,0,3,3,3,0.448276,0.538462,0,4,0,1741,0.166667
FjvJjo,FjvJjo,,0,1,1,0,1,1,1,1,1,0,118,83,1743,0
MiguArroyoPerez,MiguArroyoPerez,,1,0,1,1,0,1,0,0,0,0,118,83,1742,0
recantodasemas,recantodasemas,,1,2,3,1,2,3,2,0.666667,0.75,0,0,0,1744,0.5
dani_danitsa,dani_danitsa,,0,2,2,0,5,5,2,0.583333,0.642857,0,10,0,1745,0
dede_cutrim,dede_cutrim,,0,1,1,0,3,3,2,0.545455,0.583333,0,10,0,1746,0
mat_euzz,mat_euzz,,0,1,1,0,1,1,1,1,1,0,119,84,1748,0
alcindoholanda,alcindoholanda,,1,0,1,1,0,1,0,0,0,0,119,84,1747,0
_lais_v,_lais_v,,0,1,1,0,1,1,2,0.545455,0.583333,0,10,0,1749,0
MPTMG,MPTMG,,0,1,1,0,2,2,1,1,1,0,120,85,1751,0
MPTrabalho,MPTrabalho,,1,0,1,2,0,2,0,0,0,0,120,85,1750,0
fabianoinac,fabianoinac,,0,1,1,0,7,7,2,0.545455,0.583333,0,10,0,1752,0
tadeu_alves,tadeu_alves,,0,2,2,0,2,2,2,0.5625,0.611111,0,76,0,1754,0
RevolutionsCen,RevolutionsCen,,1,0,1,3,0,3,0,0,0,0,0,0,224,0
OIniciador,OIniciador,,1,2,3,1,2,3,1,1,1,0,76,0,1753,0.333333
leorovatti,leorovatti,,0,2,2,0,3,3,2,0.583333,0.642857,0,10,0,1755,0
fpcruz,fpcruz,,0,1,1,0,1,1,1,1,1,0,5,0,1756,0
RhangelRibeiro,RhangelRibeiro,,0,1,1,0,1,1,2,0.545455,0.583333,0,10,0,1757,0
alemnara,alemnara,,0,1,1,0,1,1,1,1,1,0,125,0,1758,0
PortalJogada10,PortalJogada10,,2,0,2,3,0,3,0,0,0,0,71,0,367,0
AnaBChassot,AnaBChassot,,0,1,1,0,1,1,1,1,1,0,5,0,1759,0
BrasilLivre20,BrasilLivre20,,0,1,1,0,1,1,1,1,1,0,88,0,1760,0
fepent,fepent,,0,1,1,0,1,1,1,1,1,0,76,0,1761,0
anaperugini,anaperugini,,3,0,3,3,0,3,0,0,0,0,0,0,223,0
TaGravadoBrasil,TaGravadoBrasil,,0,1,1,0,1,1,1,1,1,0,0,0,1762,0
DaniloA08106919,DaniloA08106919,,1,2,3,3,2,5,4,0.339623,0.365741,0,0,0,107,0.166667
JanainaDoBrasil,JanainaDoBrasil,,3,0,3,3,0,3,0,0,0,0,153,0,106,0
taynnasoares,taynnasoares,,1,1,2,2,2,4,0,0,0,0,121,86,1763,0
umbrios,umbrios,,0,4,4,0,4,4,1,1,1,0,213,0,1766,0
marciacastrorj,marciacastrorj,,1,0,1,1,0,1,0,0,0,0,213,0,1765,0
lcfons10,lcfons10,,0,2,2,0,2,2,1,1,1,0,46,0,1768,0
ClaudiaCostin,ClaudiaCostin,,1,0,1,1,0,1,0,0,0,0,46,0,1767,0
__Nikholas,__Nikholas,,0,1,1,0,1,1,2,0.545455,0.583333,0,10,0,1769,0
LeilaO26,LeilaO26,,0,1,1,0,1,1,2,0.545455,0.583333,0,10,0,1770,0
Claudia24209167,Claudia24209167,,0,1,1,0,1,1,1,1,1,0,5,0,1771,0
ForjadeHefestos,ForjadeHefestos,,1,0,1,1,0,1,0,0,0,0,80,0,1228,0
ligabombeiros,ligabombeiros,,1,0,1,1,0,1,0,0,0,0,80,0,1227,0
jcarneti,jcarneti,,0,1,1,0,1,1,1,1,1,0,122,87,1773,0
anasouza0711,anasouza0711,,1,0,1,1,0,1,0,0,0,0,122,87,1772,0
GovernodoPi,GovernodoPi,,1,0,1,1,0,1,0,0,0,0,1,1,438,0
SeducPI,SeducPI,,1,0,1,1,0,1,0,0,0,0,1,1,437,0
ROHITPANWAR2010,ROHITPANWAR2010,,0,1,1,0,1,1,1,1,1,0,97,64,1774,0
felipefonsecaps,felipefonsecaps,,0,1,1,0,1,1,2,0.545455,0.583333,0,10,0,1775,0
Alinefagundes66,Alinefagundes66,,0,1,1,0,1,1,2,0.545455,0.583333,0,10,0,1776,0
NaraSanches5,NaraSanches5,,0,1,1,0,1,1,2,0.545455,0.583333,0,10,0,1777,0
albertosampaio,albertosampaio,,0,2,2,0,2,2,3,0.421053,0.520833,0,45,0,1778,0
LulaOficial,LulaOficial,,3,0,3,3,0,3,0,0,0,0,45,0,38,0
luz_gr34,luz_gr34,,0,1,1,0,1,1,1,1,1,0,8,0,1779,0
Giancoti,Giancoti,,0,1,1,0,1,1,2,0.545455,0.583333,0,10,0,1780,0
apogeeu_,apogeeu_,,0,1,1,0,1,1,2,0.545455,0.583333,0,10,0,1781,0
uhlerelei,uhlerelei,,0,1,1,0,1,1,2,0.571429,0.625,0,5,0,1782,0
Ruthteodosio1,Ruthteodosio1,,0,1,1,0,1,1,2,0.571429,0.625,0,5,0,1783,0
BrazylChernobyl,BrazylChernobyl,,0,1,1,0,1,1,2,0.545455,0.583333,0,10,0,1784,0
joaoclcosta,joaoclcosta,,0,1,1,0,1,1,2,0.545455,0.583333,0,10,0,1785,0
ElvasnewsInfo,ElvasnewsInfo,,1,0,1,4,0,4,0,0,0,0,0,0,221,0
dacostaellie,dacostaellie,,0,1,1,0,6,6,2,0.571429,0.625,0,5,0,1786,0
anselmocontador,anselmocontador,,1,1,2,1,1,2,2,0.666667,0.75,0,76,0,220,0
Marlucia2025345,Marlucia2025345,,0,2,2,0,2,2,1,1,1,0,45,0,1787,0
jornalagora_uol,jornalagora_uol,,1,0,1,7,0,7,0,0,0,0,0,0,219,0
oamoreacura,oamoreacura,,0,1,1,0,1,1,2,0.545455,0.583333,0,10,0,1788,0
Elivelton_itaca,Elivelton_itaca,,0,1,1,0,1,1,1,1,1,0,123,88,1790,0
gilsonn55,gilsonn55,,1,0,1,1,0,1,0,0,0,0,123,88,1789,0
LciaFer95396187,LciaFer95396187,,2,4,6,3,6,9,2,0.642857,0.722222,0.000004,27,0,78,0.133333
maxpunkcwe,maxpunkcwe,,0,1,1,0,1,1,2,0.545455,0.583333,0,10,0,1791,0
keynesbreves,keynesbreves,,1,2,3,1,2,3,1,1,1,0,124,89,1794,0
boicaprichoso,boicaprichoso,,1,0,1,1,0,1,0,0,0,0,124,89,1793,0
garantido,garantido,,1,0,1,1,0,1,0,0,0,0,124,89,1792,0
marceloxaud,marceloxaud,,0,7,7,0,7,7,1,1,1,0,125,0,1800,0
eduardopaes,eduardopaes,,7,0,7,14,0,14,0,0,0,0,27,0,66,0.095238
RomeuZema,RomeuZema,,1,0,1,1,0,1,0,0,0,0,125,0,1799,0
costa_rui,costa_rui,,2,0,2,2,0,2,0,0,0,0,125,0,1798,0
ratinho_jr,ratinho_jr,,1,0,1,1,0,1,0,0,0,0,125,0,1797,0
EduardoLeite_,EduardoLeite_,,1,0,1,1,0,1,0,0,0,0,125,0,1796,0
PauloCamara40,PauloCamara40,,1,0,1,1,0,1,0,0,0,0,125,0,1795,0
BlogPecuariaJa,BlogPecuariaJa,,0,1,1,0,1,1,1,1,1,0,126,90,1802,0
feedfood,feedfood,,1,0,1,1,0,1,0,0,0,0,126,90,1801,0
SeokjinnieIsMy7,SeokjinnieIsMy7,,0,1,1,0,1,1,1,1,1,0,4,0,1803,0
BikeBlz,BikeBlz,,0,4,4,0,4,4,1,1,1,0,286,91,1808,0
TeamDSM,TeamDSM,,1,0,1,1,0,1,0,0,0,0,286,91,1807,0
kamilavintureli,kamilavintureli,,0,1,1,0,1,1,1,1,1,0,0,0,1809,0
CNTE_oficial,CNTE_oficial,,0,1,1,0,1,1,1,1,1,0,88,0,1810,0
ane_molina,ane_molina,,0,1,1,0,1,1,2,0.545455,0.583333,0,10,0,1811,0
luizgtdiniz,luizgtdiniz,,0,1,1,0,1,1,2,0.545455,0.583333,0,10,0,1812,0
CarineReisAlves,CarineReisAlves,,0,1,1,0,1,1,3,0.5,0.541667,0,76,0,1813,0
assembleiamg,assembleiamg,,9,6,15,10,8,18,2,0.875,0.928571,0.000003,76,0,215,0.009524
horadevacinar,horadevacinar,,0,1,1,0,1,1,1,1,1,0,125,0,1814,0
granjanews,granjanews,,1,0,1,2,0,2,0,0,0,0,0,0,218,0
wtfliliity,wtfliliity,,0,1,1,0,1,1,1,1,1,0,97,64,1815,0
academicsbot,academicsbot,,0,1,1,0,1,1,1,1,1,0,127,92,1817,0
Fc_gigimaritan,Fc_gigimaritan,,1,0,1,1,0,1,0,0,0,0,127,92,1816,0
Supervisora,Supervisora,,0,1,1,0,1,1,1,1,1,0,125,0,1818,0
Karinavillar19,Karinavillar19,,0,4,4,0,6,6,1,1,1,0,128,93,1823,0
GovernoRO,GovernoRO,,1,0,1,2,0,2,0,0,0,0,128,93,1822,0
rondonia,rondonia,,1,0,1,1,0,1,0,0,0,0,128,93,1821,0
Intel72197931,Intel72197931,,0,1,1,0,1,1,1,1,1,0,125,0,1824,0
disgustedhermit,disgustedhermit,,0,1,1,0,1,1,1,1,1,0,125,0,1825,0
thaynaramenezex,thaynaramenezex,,0,1,1,0,1,1,1,1,1,0,97,64,1826,0
Rotivaulo,Rotivaulo,,0,1,1,0,1,1,1,1,1,0,45,0,1827,0
PaulaGarcia_,PaulaGarcia_,,0,1,1,0,1,1,2,0.666667,0.75,0,76,0,1828,0
clair_de_loony,clair_de_loony,,0,1,1,0,1,1,2,0.571429,0.625,0,5,0,1829,0
GlauceDosSanto4,GlauceDosSanto4,,0,3,3,0,3,3,3,0.545455,0.611111,0,4,0,1830,0.5
avozdobrasil,avozdobrasil,,3,0,3,3,0,3,0,0,0,0,4,0,324,0.166667
lico_lima,lico_lima,,0,1,1,0,1,1,1,1,1,0,129,94,1832,0
tjmaoficial,tjmaoficial,,1,0,1,1,0,1,0,0,0,0,129,94,1831,0
suyanesimplicio,suyanesimplicio,,0,1,1,0,1,1,2,0.571429,0.625,0,5,0,1833,0
CoronavirusBra1,CoronavirusBra1,,1,0,1,2,0,2,0,0,0,0,128,93,1820,0
machadofnd,machadofnd,,0,1,1,0,1,1,2,0.571429,0.625,0,5,0,1834,0
otempo,otempo,,1,0,1,1,0,1,0,0,0,0,128,93,1819,0
TSendin,TSendin,,0,1,1,0,1,1,1,1,1,0,130,95,1836,0
thinkworklab,thinkworklab,,1,0,1,1,0,1,0,0,0,0,130,95,1835,0
miracletome,miracletome,,0,1,1,0,1,1,1,1,1,0,88,0,1837,0
bublitz_a,bublitz_a,,43,0,43,44,0,44,0,0,0,0,88,0,319,0
jomaria1745,jomaria1745,,0,1,1,0,1,1,2,0.545455,0.583333,0,10,0,1838,0
_tomzao,_tomzao,,0,1,1,0,1,1,2,0.571429,0.625,0,5,0,1839,0
julianacipriani,julianacipriani,,0,1,1,0,1,1,3,0.5,0.541667,0,76,0,1840,0
Senhor_Aguia,Senhor_Aguia,,0,1,1,0,1,1,2,0.545455,0.583333,0,10,0,1841,0
ptdeminas,ptdeminas,,0,1,1,0,1,1,3,0.5,0.541667,0,76,0,1842,0
mcti,mcti,,20,7,27,23,9,32,3,0.647059,0.757576,0.00001,4,0,325,0.096838
berlitz,berlitz,,0,1,1,0,1,1,2,0.571429,0.625,0,5,0,1843,0
MauroFr96360129,MauroFr96360129,,0,1,1,0,1,1,2,0.545455,0.583333,0,10,0,1844,0
CamparaClair,CamparaClair,,0,1,1,0,1,1,3,0.5,0.541667,0,76,0,1845,0
eldiario_net,eldiario_net,,1,0,1,3,0,3,0,0,0,0,0,0,210,0
MarciaC52012193,MarciaC52012193,,0,1,1,0,1,1,2,0.545455,0.583333,0,10,0,1846,0
CarecaEdvaldo,CarecaEdvaldo,,0,2,2,0,2,2,1,1,1,0,81,50,1847,0
DeniseSQ,DeniseSQ,,0,5,5,0,7,7,3,0.490741,0.525157,0,27,0,1848,0.5
HistoriaThiago,HistoriaThiago,,0,1,1,0,1,1,2,0.545455,0.583333,0,10,0,1849,0
dulcinealisboa,dulcinealisboa,,0,1,1,0,1,1,2,0.545455,0.583333,0,10,0,1850,0
Mentlliciit,Mentlliciit,,0,2,2,0,2,2,2,0.6,0.666667,0,10,0,1851,0.5
diogofosantos,diogofosantos,,0,1,1,0,1,1,1,1,1,0,131,96,1853,0
CamaraGondomar,CamaraGondomar,,1,0,1,1,0,1,0,0,0,0,131,96,1852,0
apo_source_pt,apo_source_pt,,1,0,1,5,0,5,0,0,0,0,0,0,209,0
SouzaDel23,SouzaDel23,,0,2,2,0,2,2,1,1,1,0,81,50,1854,0
mariiniss,mariiniss,,0,1,1,0,1,1,2,0.545455,0.583333,0,10,0,1855,0
TerezaCorsetti1,TerezaCorsetti1,,0,2,2,0,3,3,2,0.6,0.666667,0,10,0,1856,0.5
ivonesilva,ivonesilva,,2,0,2,2,0,2,0,0,0,0,38,0,671,0
Bradesco,Bradesco,,4,0,4,4,0,4,0,0,0,0,38,0,670,0
PFSilveira,PFSilveira,,0,2,2,0,2,2,2,0.583333,0.642857,0,213,0,1857,0
edssonrodrigues,edssonrodrigues,,0,2,2,0,2,2,2,0.583333,0.642857,0,76,0,1858,0
BotCardiology,BotCardiology,,0,1,1,0,1,1,1,1,1,0,132,0,1859,0
BlogTrendsbr,BlogTrendsbr,,4,0,4,10,0,10,0,0,0,0,132,0,116,0
filhoeterno12,filhoeterno12,,0,3,3,0,5,5,1,1,1,0,76,0,1860,0
calmonvaleria_,calmonvaleria_,,0,1,1,0,1,1,2,0.571429,0.625,0,5,0,1861,0
bkbrika,bkbrika,,0,2,2,0,3,3,1,1,1,0,25,0,1863,0
YouTube,YouTube,,2,0,2,2,0,2,0,0,0,0,25,0,1862,0
crispirillo,crispirillo,,0,1,1,0,4,4,1,1,1,0,132,0,1864,0
ufmg99,ufmg99,,0,1,1,0,4,4,1,1,1,0,132,0,1865,0
Natalyuska1st,Natalyuska1st,,0,1,1,0,2,2,1,1,1,0,5,0,1866,0
pmmrcosta,pmmrcosta,,0,2,2,0,3,3,2,0.75,0.833333,0,8,0,1867,0.5
cmen2908,cmen2908,,0,1,1,0,4,4,2,0.545455,0.583333,0,10,0,1868,0
DanilosLeite,DanilosLeite,,0,1,1,0,1,1,1,1,1,0,88,0,1869,0
evangelisttarte,evangelisttarte,,0,1,1,0,1,1,2,0.666667,0.75,0,115,0,1870,0
mirtheswilliams,mirtheswilliams,,0,3,3,0,3,3,1,1,1,0,133,97,1874,0
oocmaribeth,oocmaribeth,,1,0,1,1,0,1,0,0,0,0,133,97,1873,0
_milhojas,_milhojas,,1,0,1,1,0,1,0,0,0,0,133,97,1872,0
programapanico,programapanico,,1,0,1,1,0,1,0,0,0,0,133,97,1871,0
JosMaurciodeMe1,JosMaurciodeMe1,,0,2,2,0,2,2,1,1,1,0,4,0,1875,0
Blommiriam1,Blommiriam1,,0,1,1,0,1,1,2,0.545455,0.583333,0,10,0,1876,0
money37442150,money37442150,,0,1,1,0,1,1,1,1,1,0,50,0,1877,0
JorgeAvellarBR,JorgeAvellarBR,,0,1,1,0,1,1,1,1,1,0,4,0,1878,0
camisdjesus,camisdjesus,,0,1,1,0,1,1,2,0.571429,0.625,0,5,0,1879,0
Ka98249643,Ka98249643,,0,1,1,0,1,1,1,1,1,0,153,0,1880,0
Marliga,Marliga,,0,2,2,0,3,3,2,0.6,0.666667,0,10,0,1881,0.5
celcarlao,celcarlao,,0,1,1,0,1,1,2,0.545455,0.583333,0,10,0,1882,0
lourencyjr,lourencyjr,,0,1,1,0,3,3,1,1,1,0,71,0,1883,0
opaisonline,opaisonline,,4,0,4,8,0,8,0,0,0,0,71,0,1253,0
MariaSa84334065,MariaSa84334065,,0,1,1,0,1,1,2,0.6,0.666667,0,8,0,1884,0
deca_deca4,deca_deca4,,0,1,1,0,1,1,2,0.545455,0.583333,0,10,0,1885,0
cmsvarginha,cmsvarginha,,0,1,1,0,1,1,1,1,1,0,125,0,1886,0
Reinaldo1Mauri1,Reinaldo1Mauri1,,0,1,1,0,1,1,2,0.571429,0.625,0,5,0,1887,0
diegojunqueira,diegojunqueira,,0,1,1,0,1,1,1,1,1,0,5,0,1888,0
paravertudo,paravertudo,,0,3,3,0,3,3,1,1,1,0,8,0,1890,0
EmDiaES,EmDiaES,,2,0,2,5,0,5,0,0,0,0,0,0,208,0
Carla33825425,Carla33825425,,0,1,1,0,3,3,2,0.545455,0.583333,0,10,0,1891,0
VergilioUgolini,VergilioUgolini,,0,1,1,0,1,1,2,0.571429,0.625,0,5,0,1892,0
Flavionovaes,Flavionovaes,,0,3,3,0,3,3,4,0.452991,0.487421,0,27,0,1893,0.5
GeraldoSiFi30,GeraldoSiFi30,,0,1,1,0,1,1,2,0.571429,0.625,0,5,0,1894,0
pneumolugia,pneumolugia,,0,1,1,0,1,1,2,0.545455,0.583333,0,10,0,1895,0
Evelingmail,Evelingmail,,0,1,1,0,1,1,2,0.545455,0.583333,0,10,0,1896,0
eliotjunior360,eliotjunior360,,0,1,1,0,1,1,1,1,1,0,5,0,1897,0
AldoNunes57,AldoNunes57,,0,2,2,0,2,2,1,1,1,0,88,0,1898,0
Paulinhoapol,Paulinhoapol,,0,6,6,0,33,33,1,1,1,0,4,0,1899,0.033333
IvyLaly,IvyLaly,,0,1,1,0,1,1,2,0.545455,0.583333,0,10,0,1900,0
ClaudiaLaman,ClaudiaLaman,,0,1,1,0,1,1,1,1,1,0,134,98,1902,0
CAdeMGomes,CAdeMGomes,,1,0,1,1,0,1,0,0,0,0,134,98,1901,0
artemis369,artemis369,,0,1,1,0,1,1,2,0.545455,0.583333,0,10,0,1903,0
brunoreisba,brunoreisba,,2,0,2,6,0,6,0,0,0,0,27,0,86,1
antoniocamaro,antoniocamaro,,0,1,1,0,2,2,1,1,1,0,29,0,1904,0
MadalenaDaniela,MadalenaDaniela,,0,1,1,0,1,1,2,0.6,0.666667,0,8,0,1905,0
Roni_Egashira,Roni_Egashira,,0,2,2,0,2,2,1,1,1,0,213,0,1906,0
FZezinhos,FZezinhos,,1,0,1,1,0,1,0,0,0,0,0,0,234,0
Fightforbadser1,Fightforbadser1,,0,1,1,0,1,1,2,0.6,0.666667,0,88,0,1907,0
pfizer,pfizer,,5,0,5,5,0,5,0,0,0,0,31,0,200,0
Baxter,Baxter,,1,0,1,1,0,1,0,0,0,0,45,0,199,0
Novartis,Novartis,,1,0,1,1,0,1,0,0,0,0,45,0,198,0
curevac,curevac,,1,0,1,1,0,1,0,0,0,0,45,0,197,0
takeda,takeda,,1,0,1,1,0,1,0,0,0,0,45,0,196,0
cassioluis7,cassioluis7,,0,1,1,0,1,1,1,1,1,0,62,0,1908,0
INACIO_TRICOLOR,INACIO_TRICOLOR,,0,1,1,0,1,1,1,1,1,0,135,99,1910,0
EuJesusCristu,EuJesusCristu,,1,0,1,1,0,1,0,0,0,0,135,99,1909,0
rebuid,rebuid,,2,0,2,2,0,2,0,0,0,0,45,0,188,1
joyellowsub,joyellowsub,,0,6,6,0,6,6,3,0.495327,0.534591,0,27,0,1911,0.4
PriscilaRabelo,PriscilaRabelo,,0,1,1,0,1,1,1,1,1,0,125,0,1912,0
Diga_NaoMane,Diga_NaoMane,,0,1,1,0,1,1,1,1,1,0,45,0,1913,0
Arce85Azul,Arce85Azul,,0,1,1,0,1,1,1,1,1,0,29,0,1914,0
Ricardocseidl,Ricardocseidl,,0,3,3,0,3,3,4,0.452991,0.487421,0,27,0,1915,0.5
frjunioradv,frjunioradv,,0,1,1,0,1,1,1,1,1,0,41,0,1916,0
sputnik_brasil,sputnik_brasil,,8,0,8,9,0,9,0,0,0,0,41,0,739,0
safiraprado,safiraprado,,0,1,1,0,1,1,2,0.571429,0.625,0,5,0,1917,0
inifiocruz,inifiocruz,,0,2,2,0,11,11,1,1,1,0,76,0,1918,1
CpcorpOrw,CpcorpOrw,,0,1,1,0,1,1,1,1,1,0,136,100,1920,0
JorgeO,JorgeO,,1,0,1,1,0,1,0,0,0,0,136,100,1919,0
Vosso_Amigo,Vosso_Amigo,,0,1,1,0,1,1,1,1,1,0,10,0,1921,0
CanaldoFalcao1,CanaldoFalcao1,,1,0,1,1,0,1,0,0,0,0,0,0,233,0
jmarzola1,jmarzola1,,0,1,1,0,2,2,1,1,1,0,41,0,1922,0
wil_scaliante,wil_scaliante,,0,1,1,0,1,1,1,1,1,0,88,0,1923,0
Lt_Morant,Lt_Morant,,0,1,1,0,1,1,3,0.388889,0.452381,0,10,0,1924,0
marianacduque,marianacduque,,0,1,1,0,1,1,2,0.545455,0.583333,0,10,0,1925,0
simonegmoreno,simonegmoreno,,0,1,1,0,1,1,2,0.545455,0.583333,0,10,0,1926,0
8_jorgealopezg,8_jorgealopezg,,0,1,1,0,1,1,1,1,1,0,29,0,1927,0
charlesgenetica,charlesgenetica,,0,1,1,0,1,1,1,1,1,0,10,0,1928,0
crisfamer,crisfamer,,0,1,1,0,1,1,1,1,1,0,41,0,1929,0
RaiodeLuz555,RaiodeLuz555,,0,4,4,0,7,7,2,0.666667,0.75,0,10,0,1930,0.25
jepthur,jepthur,,0,1,1,0,1,1,2,0.545455,0.583333,0,10,0,1931,0
RenestoM,RenestoM,,0,1,1,0,1,1,2,0.545455,0.583333,0,10,0,1932,0
CharlesDalberto,CharlesDalberto,,0,1,1,0,1,1,2,0.545455,0.583333,0,10,0,1933,0
AmarildoGuerra1,AmarildoGuerra1,,0,2,2,0,2,2,2,0.583333,0.642857,0,213,0,1934,0
AlessaNilo,AlessaNilo,,2,2,4,2,2,4,1,1,1,0,137,101,1936,0.5
gestospe,gestospe,,2,0,2,2,0,2,0,0,0,0,137,101,1935,0.5
forumungassaids,forumungassaids,,0,2,2,0,2,2,1,1,1,0,137,101,1937,0.5
SergioDNunes,SergioDNunes,,0,1,1,0,1,1,2,0.545455,0.583333,0,10,0,1938,0
HeloisaBernste1,HeloisaBernste1,,0,1,1,0,1,1,2,0.545455,0.583333,0,10,0,1939,0
Raposa_2T,Raposa_2T,,0,1,1,0,1,1,2,0.545455,0.583333,0,10,0,1940,0
Bebethsal,Bebethsal,,0,1,1,0,1,1,2,0.666667,0.75,0,10,0,1941,0
nelsonmaf,nelsonmaf,,0,1,1,0,1,1,1,1,1,0,88,0,1942,0
OrlandoMachado,OrlandoMachado,,0,4,4,0,4,4,2,0.642857,0.722222,0,213,0,1943,0
AntnioM85638126,AntnioM85638126,,0,1,1,0,1,1,1,1,1,0,41,0,1944,0
charlesparreir1,charlesparreir1,,0,3,3,0,3,3,2,0.714286,0.8,0,62,0,1946,0
Carol_Lammour,Carol_Lammour,,1,0,1,1,0,1,0,0,0,0,62,0,1945,0
tmueta,tmueta,,0,1,1,0,1,1,1,1,1,0,138,102,1948,0
UFMT,UFMT,,1,0,1,1,0,1,0,0,0,0,138,102,1947,0
valcris15011791,valcris15011791,,0,1,1,0,1,1,2,0.545455,0.583333,0,10,0,1949,0
ProletarioRS,ProletarioRS,,0,1,1,0,1,1,2,0.545455,0.583333,0,10,0,1950,0
brmais2,brmais2,,0,2,2,0,2,2,2,0.583333,0.642857,0,10,0,1951,0
RelativeBrain,RelativeBrain,,0,1,1,0,1,1,1,1,1,0,10,0,1952,0
cris_rodriiigue,cris_rodriiigue,,0,3,3,0,10,10,2,0.636364,0.714286,0,10,0,1953,0.166667
anvisa_oficial,anvisa_oficial,,9,0,9,10,0,10,0,0,0,0,62,0,61,0.027778
sindbiespi,sindbiespi,,0,2,2,0,3,3,2,0.6,0.666667,0,10,0,1954,0.5
edmthabie,edmthabie,,0,1,1,0,1,1,1,1,1,0,10,0,1955,0
RenataBastosSS,RenataBastosSS,,0,1,1,0,1,1,2,0.545455,0.583333,0,10,0,1956,0
LacyrToto,LacyrToto,,0,1,1,0,1,1,2,0.545455,0.583333,0,10,0,1957,0
Malori99,Malori99,,0,1,1,0,1,1,2,0.545455,0.583333,0,10,0,1958,0
abcereja,abcereja,,0,1,1,0,1,1,2,0.545455,0.583333,0,10,0,1959,0
brazilcoll,brazilcoll,,0,5,5,0,5,5,2,0.631579,0.708333,0,0,0,1960,0.1
val_alvarenga,val_alvarenga,,0,1,1,0,1,1,1,1,1,0,10,0,1961,0
todylopes,todylopes,,0,1,1,0,1,1,1,1,1,0,10,0,1962,0
Perseu54847237,Perseu54847237,,0,1,1,0,1,1,1,1,1,0,10,0,1963,0
Deh_vercosa,Deh_vercosa,,0,2,2,0,2,2,1,1,1,0,76,0,1964,0
Phantom_Finance,Phantom_Finance,,0,2,2,0,2,2,2,0.666667,0.75,0,0,0,1968,0
Ex24hs,Ex24hs,,1,0,1,1,0,1,0,0,0,0,0,0,1967,0
redenanosaude,redenanosaude,,0,2,2,0,2,2,2,0.583333,0.642857,0,10,0,1969,0.5
MonicaGil01,MonicaGil01,,0,1,1,0,1,1,2,0.545455,0.583333,0,10,0,1970,0
Ricalyra,Ricalyra,,0,1,1,0,1,1,2,0.666667,0.75,0,115,0,1971,0
DanillorafaM,DanillorafaM,,0,1,1,0,1,1,1,1,1,0,10,0,1972,0
babypiensfw,babypiensfw,,0,1,1,0,1,1,1,1,1,0,10,0,1973,0
TavaresAriel,TavaresAriel,,0,1,1,0,1,1,1,1,1,0,139,103,1975,0
marciobjardim,marciobjardim,,1,0,1,1,0,1,0,0,0,0,139,103,1974,0
Iliana38421765,Iliana38421765,,0,1,1,0,1,1,1,1,1,0,10,0,1976,0
uberdam,uberdam,,0,1,1,0,1,1,1,1,1,0,10,0,1977,0
carol_pgil,carol_pgil,,0,1,1,0,1,1,2,0.545455,0.583333,0,10,0,1978,0
AndreJustino50,AndreJustino50,,1,0,1,1,0,1,0,0,0,0,0,0,186,0
porcogobatto86,porcogobatto86,,0,1,1,0,1,1,1,1,1,0,5,0,1979,0
bicicreta,bicicreta,,0,1,1,0,1,1,2,0.545455,0.583333,0,10,0,1980,0
mssilva77,mssilva77,,0,1,1,0,3,3,2,0.545455,0.583333,0,10,0,1981,0
MaGioZal,MaGioZal,,1,0,1,1,0,1,0,0,0,0,10,0,366,0
Racheldomi,Racheldomi,,0,2,2,0,2,2,2,0.583333,0.642857,0,76,0,1982,0
Intermexe,Intermexe,,0,1,1,0,1,1,2,0.545455,0.583333,0,10,0,1983,0
aecio141,aecio141,,0,1,1,0,1,1,2,0.545455,0.583333,0,10,0,1984,0
giancarlozero,giancarlozero,,0,1,1,0,1,1,2,0.545455,0.583333,0,10,0,1985,0
rodrigay_,rodrigay_,,0,1,1,0,1,1,1,1,1,0,140,104,1987,0
maricelsojunior,maricelsojunior,,1,0,1,1,0,1,0,0,0,0,140,104,1986,0
GenivalDamasce1,GenivalDamasce1,,0,1,1,0,1,1,1,1,1,0,4,0,1988,0
BielAlmodovar,BielAlmodovar,,1,2,3,1,4,5,1,1,1,0,0,0,1966,0.166667
2015Fmbs,2015Fmbs,,0,1,1,0,1,1,1,1,1,0,4,0,1989,0
bluiz2010,bluiz2010,,0,1,1,0,1,1,1,1,1,0,25,0,1990,0
Guttto,Guttto,,0,4,4,0,5,5,3,0.518519,0.607143,0,76,0,1991,0.416667
marildamsantos,marildamsantos,,0,1,1,0,1,1,1,1,1,0,4,0,1992,0
Antonio208020,Antonio208020,,0,1,1,0,1,1,1,1,1,0,4,0,1993,0
WellynaS_,WellynaS_,,0,1,1,0,1,1,2,0.545455,0.583333,0,10,0,1994,0
Ogabrielgg,Ogabrielgg,,1,0,1,1,0,1,0,0,0,0,0,0,183,0
Andre_leao1906,Andre_leao1906,,0,1,1,0,1,1,1,1,1,0,49,30,1995,0
CunhaJay,CunhaJay,,0,1,1,0,1,1,1,1,1,0,4,0,1996,0
DanielFLieff,DanielFLieff,,0,1,1,0,1,1,1,1,1,0,4,0,1997,0
Maria_Irritada,Maria_Irritada,,0,1,1,0,1,1,2,0.545455,0.583333,0,10,0,1998,0
LianeBorn,LianeBorn,,0,1,1,0,1,1,2,0.545455,0.583333,0,10,0,1999,0
persone_09,persone_09,,0,1,1,0,1,1,2,0.545455,0.583333,0,10,0,2000,0
gaudium73,gaudium73,,0,1,1,0,1,1,1,1,1,0,0,0,2001,0
juliangf74,juliangf74,,0,1,1,0,1,1,1,1,1,0,0,0,2002,0
ceellla,ceellla,,0,1,1,0,1,1,2,0.545455,0.583333,0,10,0,2003,0
Luzem1,Luzem1,,0,1,1,0,1,1,1,1,1,0,141,0,2004,0
proindio,proindio,,5,0,5,5,0,5,0,0,0,0,141,0,365,0
SrtaLee123,SrtaLee123,,0,1,1,0,1,1,1,1,1,0,4,0,2005,0
MannyMtzA,MannyMtzA,,0,1,1,0,1,1,1,1,1,0,0,0,2006,0
carsafa521,carsafa521,,0,1,1,0,1,1,1,1,1,0,0,0,2007,0
jorgemcorderom,jorgemcorderom,,0,1,1,0,1,1,1,1,1,0,0,0,2008,0
Ceclio16,Ceclio16,,0,1,1,0,1,1,1,1,1,0,4,0,2009,0
JaciraMonta,JaciraMonta,,0,1,1,0,1,1,2,0.545455,0.583333,0,10,0,2010,0
Cami45pp,Cami45pp,,0,1,1,0,1,1,1,1,1,0,0,0,2011,0
mariocampos,mariocampos,,0,1,1,0,1,1,1,1,1,0,0,0,2012,0
suzana_barberio,suzana_barberio,,0,1,1,0,1,1,1,1,1,0,25,0,2013,0
SigaGazetaBR,SigaGazetaBR,,5,0,5,5,0,5,0,0,0,0,25,0,490,0
GhiBordin,GhiBordin,,0,1,1,0,1,1,1,1,1,0,4,0,2014,0
FilhoRq,FilhoRq,,0,1,1,0,2,2,1,1,1,0,25,0,2015,0
ramos_destro,ramos_destro,,0,1,1,0,1,1,1,1,1,0,4,0,2016,0
Manoel21527662,Manoel21527662,,0,1,1,0,1,1,1,1,1,0,4,0,2017,0
SystemTitanium,SystemTitanium,,0,1,1,0,2,2,1,1,1,0,25,0,2018,0
CleideA44305992,CleideA44305992,,0,1,1,0,1,1,1,1,1,0,4,0,2019,0
covidestanoar,covidestanoar,,0,1,1,0,1,1,1,1,1,0,142,105,2021,0
vanssilveira,vanssilveira,,1,0,1,1,0,1,0,0,0,0,142,105,2020,0
JC_Barajas,JC_Barajas,,0,1,1,0,1,1,1,1,1,0,143,106,2023,0
Luis_C_Sandoval,Luis_C_Sandoval,,1,0,1,1,0,1,0,0,0,0,143,106,2022,0
sergioyendo,sergioyendo,,0,1,1,0,1,1,1,1,1,0,5,0,2024,0
divinaisis,divinaisis,,0,1,1,0,1,1,1,1,1,0,25,0,2025,0
DanielRanieri3,DanielRanieri3,,0,1,1,0,2,2,1,1,1,0,25,0,2026,0
fabriciohorta,fabriciohorta,,0,1,1,0,2,2,2,0.545455,0.583333,0,10,0,2027,0
DorocheMauro,DorocheMauro,,0,1,1,0,1,1,1,1,1,0,4,0,2028,0
BerniniCida,BerniniCida,,0,2,2,0,2,2,1,1,1,0,144,107,2031,0.5
sinprodf,sinprodf,,1,1,2,1,1,2,1,1,1,0,144,107,2030,0.5
Gov_DF,Gov_DF,,2,0,2,2,0,2,0,0,0,0,144,107,2029,0.5
sonlaurentino,sonlaurentino,,0,1,1,0,1,1,1,1,1,0,141,0,2032,0
KihtiReto,KihtiReto,,0,1,1,0,1,1,1,1,1,0,141,0,2033,0
Mikkoli,Mikkoli,,0,1,1,0,1,1,1,1,1,0,141,0,2034,0
SuelyTonin,SuelyTonin,,0,1,1,0,2,2,1,1,1,0,25,0,2035,0
ManitiF,ManitiF,,0,1,1,0,1,1,1,1,1,0,25,0,2036,0
jacintamonteir1,jacintamonteir1,,0,1,1,0,1,1,1,1,1,0,25,0,2037,0
pabloSantos01,pabloSantos01,,0,1,1,0,1,1,1,1,1,0,4,0,2038,0
gercioeli,gercioeli,,0,1,1,0,1,1,1,1,1,0,25,0,2039,0
UlyssesBraga1,UlyssesBraga1,,0,2,2,0,2,2,1,1,1,0,4,0,2040,0
Cesar2045Cesar,Cesar2045Cesar,,0,1,1,0,1,1,1,1,1,0,4,0,2041,0
Leopoldohepta,Leopoldohepta,,0,1,1,0,1,1,1,1,1,0,4,0,2042,0
tavares6_waldir,tavares6_waldir,,0,1,1,0,1,1,1,1,1,0,4,0,2043,0
Marilda75409433,Marilda75409433,,0,4,4,0,9,9,2,0.576923,0.633333,0,10,0,2044,0
tehdoideh,tehdoideh,,0,1,1,0,1,1,1,1,1,0,145,108,2046,0
tiagobentancour,tiagobentancour,,1,0,1,1,0,1,0,0,0,0,145,108,2045,0
PenhaPiccolo,PenhaPiccolo,,0,1,1,0,2,2,1,1,1,0,25,0,2047,0
BrunaAntures,BrunaAntures,,0,1,1,0,1,1,1,1,1,0,4,0,2048,0
opentefino,opentefino,,2,0,2,5,0,5,0,0,0,0,0,0,181,0
pastor_marcel,pastor_marcel,,0,1,1,0,1,1,1,1,1,0,4,0,2049,0
isainho,isainho,,0,1,1,0,1,1,1,1,1,0,25,0,2050,0
Petrovarius,Petrovarius,,0,1,1,0,2,2,1,1,1,0,25,0,2051,0
Flavinha_AB,Flavinha_AB,,0,1,1,0,1,1,2,0.666667,0.75,0,45,0,2053,0
TVJustica,TVJustica,,2,1,3,2,1,3,1,1,1,0,45,0,2052,0
olivionava,olivionava,,0,2,2,0,2,2,1,1,1,0,4,0,2054,0
FernandaKellner,FernandaKellner,,0,1,1,0,1,1,1,1,1,0,25,0,2055,0
cleverson_rego,cleverson_rego,,0,1,1,0,2,2,1,1,1,0,25,0,2056,0
ideias_c,ideias_c,,1,1,2,1,1,2,1,1,1,0,0,0,180,0.5
JornalLex,JornalLex,,2,0,2,2,0,2,0,0,0,0,0,0,179,0.5
marciamatos77,marciamatos77,,0,1,1,0,1,1,1,1,1,0,25,0,2057,0
beregmaciel,beregmaciel,,0,1,1,0,1,1,1,1,1,0,25,0,2058,0
_utipac,_utipac,,0,1,1,0,2,2,1,1,1,0,41,0,2059,0
yredlav,yredlav,,0,1,1,0,1,1,2,0.545455,0.583333,0,10,0,2060,0
infoambiental,infoambiental,,0,1,1,0,2,2,2,0.545455,0.583333,0,10,0,2061,0
bcbm15,bcbm15,,0,1,1,0,2,2,1,1,1,0,25,0,2062,0
Carla40882077,Carla40882077,,0,1,1,0,3,3,2,0.545455,0.583333,0,10,0,2063,0
GrangerAlves,GrangerAlves,,0,1,1,0,1,1,1,1,1,0,25,0,2064,0
Vivianerecife,Vivianerecife,,0,1,1,0,2,2,1,1,1,0,25,0,2065,0
Igor_Barretto,Igor_Barretto,,0,1,1,0,1,1,1,1,1,0,25,0,2066,0
Camilo20211,Camilo20211,,0,1,1,0,1,1,1,1,1,0,4,0,2067,0
Oliveira892345,Oliveira892345,,0,1,1,0,1,1,1,1,1,0,4,0,2068,0
ToniatoMi,ToniatoMi,,0,1,1,0,1,1,1,1,1,0,25,0,2069,0
joquari,joquari,,0,1,1,0,2,2,1,1,1,0,25,0,2070,0
RogrioJosPinto1,RogrioJosPinto1,,0,1,1,0,1,1,1,1,1,0,25,0,2071,0
NPersonalander,NPersonalander,,2,3,5,2,3,5,1,1,1,0,50,0,2072,0.25
Clara46397117,Clara46397117,,0,1,1,0,3,3,2,0.545455,0.583333,0,10,0,2073,0
claudemirmirand,claudemirmirand,,0,1,1,0,1,1,1,1,1,0,4,0,2074,0
Anousca65,Anousca65,,0,1,1,0,1,1,1,1,1,0,25,0,2075,0
magdielnascimen,magdielnascimen,,0,1,1,0,2,2,1,1,1,0,25,0,2076,0
dea_ln_,dea_ln_,,0,1,1,0,2,2,1,1,1,0,25,0,2077,0
das_gramor,das_gramor,,0,2,2,0,2,2,1,1,1,0,146,109,2080,0
Eu_Laira,Eu_Laira,,1,0,1,1,0,1,0,0,0,0,146,109,2079,0
padilhando,padilhando,,1,0,1,1,0,1,0,0,0,0,146,109,2078,0
MaJorSantos,MaJorSantos,,0,1,1,0,1,1,1,1,1,0,25,0,2081,0
1976Mnc,1976Mnc,,0,1,1,0,2,2,1,1,1,0,25,0,2082,0
Aline_lfa,Aline_lfa,,0,2,2,0,2,2,1,1,1,0,4,0,2083,0
sjshelties,sjshelties,,0,1,1,0,2,2,1,1,1,0,25,0,2084,0
wandercsalles2,wandercsalles2,,0,1,1,0,1,1,1,1,1,0,4,0,2085,0
CarlaPatMG,CarlaPatMG,,0,1,1,0,2,2,1,1,1,0,25,0,2086,0
XucraDireita,XucraDireita,,0,1,1,0,2,2,1,1,1,0,25,0,2087,0
AlessandraBremm,AlessandraBremm,,0,1,1,0,1,1,2,0.545455,0.583333,0,10,0,2088,0
ConservadoraFNX,ConservadoraFNX,,0,1,1,0,1,1,1,1,1,0,25,0,2089,0
Luciano31369221,Luciano31369221,,0,1,1,0,1,1,1,1,1,0,4,0,2090,0
RobsonBoxe,RobsonBoxe,,0,1,1,0,2,2,1,1,1,0,25,0,2091,0
dersinho13,dersinho13,,0,1,1,0,1,1,1,1,1,0,25,0,2092,0
PatriaAmada8,PatriaAmada8,,0,1,1,0,1,1,1,1,1,0,25,0,2093,0
piloto2012,piloto2012,,0,1,1,0,1,1,1,1,1,0,4,0,2094,0
MarcelinoCarv,MarcelinoCarv,,0,1,1,0,1,1,1,1,1,0,4,0,2095,0
ndazev,ndazev,,0,1,1,0,2,2,1,1,1,0,25,0,2096,0
ki07110484,ki07110484,,0,1,1,0,2,2,1,1,1,0,25,0,2097,0
dominiofeminino,dominiofeminino,,0,1,1,0,2,2,1,1,1,0,25,0,2098,0
rickcarvalho007,rickcarvalho007,,0,1,1,0,1,1,1,1,1,0,25,0,2099,0
VictorA70286753,VictorA70286753,,0,1,1,0,2,2,1,1,1,0,25,0,2100,0
MSK182931,MSK182931,,0,1,1,0,1,1,1,1,1,0,25,0,2101,0
AndreQueirozz4,AndreQueirozz4,,0,1,1,0,1,1,1,1,1,0,25,0,2102,0
mavericknewss,mavericknewss,,0,1,1,0,1,1,1,1,1,0,4,0,2103,0
MartaRabelloSa1,MartaRabelloSa1,,0,1,1,0,1,1,1,1,1,0,4,0,2104,0
esper_alberto,esper_alberto,,0,1,1,0,1,1,1,1,1,0,4,0,2105,0
otavioavilaaa,otavioavilaaa,,0,1,1,0,1,1,2,0.545455,0.583333,0,10,0,2106,0
plot_start,plot_start,,0,1,1,0,1,1,2,0.545455,0.583333,0,10,0,2107,0
glauberjaa,glauberjaa,,0,1,1,0,1,1,1,1,1,0,4,0,2108,0
Carolmph,Carolmph,,0,1,1,0,1,1,1,1,1,0,4,0,2109,0
Rulad0,Rulad0,,0,1,1,0,2,2,2,0.545455,0.583333,0,10,0,2110,0
wtoume,wtoume,,0,5,5,0,9,9,2,0.631579,0.708333,0,10,0,2111,0.05
vieiratheusm,vieiratheusm,,0,1,1,0,1,1,1,1,1,0,0,0,2112,0
Maria98823347,Maria98823347,,0,1,1,0,1,1,2,0.545455,0.583333,0,10,0,2113,0
SarahFeanor,SarahFeanor,,0,1,1,0,1,1,2,0.545455,0.583333,0,10,0,2114,0
jefogocenoura,jefogocenoura,,0,1,1,0,1,1,2,0.545455,0.583333,0,10,0,2115,0
flaviamadruga,flaviamadruga,,0,1,1,0,1,1,2,0.545455,0.583333,0,10,0,2116,0
KetyFrancis,KetyFrancis,,0,1,1,0,1,1,2,0.545455,0.583333,0,10,0,2117,0
ClementinoIlnah,ClementinoIlnah,,0,1,1,0,1,1,2,0.545455,0.583333,0,10,0,2118,0
BiaRMesquita,BiaRMesquita,,0,1,1,0,1,1,2,0.545455,0.583333,0,10,0,2119,0
claudicou,claudicou,,0,1,1,0,2,2,2,0.545455,0.583333,0,10,0,2120,0
portalVALENTlNA,portalVALENTlNA,,3,1,4,6,1,7,1,1,1,0,147,0,178,0.166667
AlkminLeandra,AlkminLeandra,,0,1,1,0,1,1,2,0.6,0.666667,0,50,0,2121,0
ninouk72,ninouk72,,0,1,1,0,1,1,1,1,1,0,31,0,2122,0
AndersonCardeal,AndersonCardeal,,1,0,1,1,0,1,0,0,0,0,10,0,363,0
folhadamatamg,folhadamatamg,,1,0,1,1,0,1,0,0,0,0,10,0,362,0
Gussono,Gussono,,0,1,1,0,1,1,2,0.545455,0.583333,0,10,0,2123,0
osmarpaulinode1,osmarpaulinode1,,0,1,1,0,1,1,1,1,1,0,38,0,2124,0
M5PaBr,M5PaBr,,0,1,1,0,1,1,1,1,1,0,41,0,2125,0
juniorgomesneto,juniorgomesneto,,0,1,1,0,1,1,1,1,1,0,62,0,2126,0
RadioagenciaEBC,RadioagenciaEBC,,11,3,14,11,6,17,4,0.478261,0.583333,0.000002,4,0,325,0.076923
fabioguimaraess,fabioguimaraess,,0,2,2,0,2,2,1,1,1,0,58,0,2127,0
Portal_T5,Portal_T5,,1,0,1,6,0,6,0,0,0,0,147,0,746,0
aman_tita,aman_tita,,0,1,1,0,1,1,1,1,1,0,41,0,2128,0
TieppoSandra,TieppoSandra,,0,1,1,0,1,1,2,0.545455,0.583333,0,10,0,2129,0
caab25,caab25,,0,1,1,0,1,1,1,1,1,0,68,42,2130,0
skate_forever,skate_forever,,0,2,2,0,2,2,1,1,1,0,88,0,2132,0.5
endersonmaia,endersonmaia,,1,1,2,1,1,2,1,1,1,0,88,0,2131,0.5
Direita_Ja_2018,Direita_Ja_2018,,0,2,2,0,2,2,1,1,1,0,25,0,2133,0
AMouraFe70,AMouraFe70,,0,2,2,0,2,2,1,1,1,0,125,0,2134,0.5
luindarkness,luindarkness,,0,1,1,0,3,3,2,0.545455,0.583333,0,10,0,2135,0
s_riicardo,s_riicardo,,0,1,1,0,1,1,1,1,1,0,58,0,2136,0
mpce_oficial,mpce_oficial,,1,0,1,1,0,1,0,0,0,0,10,0,361,0
raquelalmeida,raquelalmeida,,0,2,2,0,3,3,2,0.583333,0.642857,0,10,0,2137,0
WilsonGB2014,WilsonGB2014,,0,1,1,0,1,1,1,1,1,0,148,0,2138,0
unicef_bissau,unicef_bissau,,4,0,4,4,0,4,0,0,0,0,148,0,176,0
ScienceBot8,ScienceBot8,,0,4,4,0,6,6,1,1,1,0,76,0,2140,0.333333
AgenciaFAPESP,AgenciaFAPESP,,15,2,17,17,2,19,1,1,1,0.000001,76,0,638,0.016667
Unesp_Oficial,Unesp_Oficial,,3,0,3,3,0,3,0,0,0,0,76,0,637,0.166667
SenadoFederal,SenadoFederal,,1,0,1,1,0,1,0,0,0,0,0,0,232,0
PCdoBnaCamara,PCdoBnaCamara,,0,1,1,0,1,1,1,1,1,0,149,110,2142,0
PCdoB_Oficial,PCdoB_Oficial,,1,0,1,1,0,1,0,0,0,0,149,110,2141,0
Stock__Analyst,Stock__Analyst,,0,1,1,0,1,1,1,1,1,0,150,111,2144,0
TraderRook,TraderRook,,3,0,3,3,0,3,0,0,0,0,150,111,2143,0
TaxesOnFire,TaxesOnFire,,0,1,1,0,1,1,1,1,1,0,150,111,2145,0
BrizJorge,BrizJorge,,0,1,1,0,1,1,1,1,1,0,150,111,2146,0
comunicacac,comunicacac,,0,1,1,0,1,1,1,1,1,0,151,112,2148,0
ufpeoficial,ufpeoficial,,1,0,1,1,0,1,0,0,0,0,151,112,2147,0
PauloAntnioDa11,PauloAntnioDa11,,0,1,1,0,1,1,1,1,1,0,38,0,2149,0
ZeLuchetti,ZeLuchetti,,0,1,1,0,1,1,1,1,1,0,33,21,2150,0
fabioebl,fabioebl,,0,1,1,0,1,1,1,1,1,0,5,0,2151,0
BGenebra,BGenebra,,0,6,6,0,10,10,3,0.5,0.605263,0,5,0,2152,0.066667
Manowell1979,Manowell1979,,1,0,1,1,0,1,0,0,0,0,57,0,408,0
Sandra08904140,Sandra08904140,,2,0,2,6,0,6,0,0,0,0,57,0,407,0.5
GFiuza_Oficial,GFiuza_Oficial,,4,0,4,8,0,8,0,0,0,0,57,0,150,0.166667
HugaoDF_TO,HugaoDF_TO,,0,2,2,0,2,2,1,1,1,0,5,0,2153,0
FNUCUT,FNUCUT,,0,1,1,0,1,1,1,1,1,0,76,0,2154,0
RC_RAMIRES,RC_RAMIRES,,0,1,1,0,1,1,1,1,1,0,50,0,2155,0
DelfimMendes95,DelfimMendes95,,0,1,1,0,1,1,1,1,1,0,148,0,2156,0
TaniaMariaFelix,TaniaMariaFelix,,0,1,1,0,1,1,1,1,1,0,38,0,2157,0
MarceloJGonca,MarceloJGonca,,0,3,3,0,4,4,2,0.636364,0.714286,0,0,0,2158,0.166667
givaldo_lucas,givaldo_lucas,,0,1,1,0,1,1,1,1,1,0,38,0,2159,0
CGEE_oficial,CGEE_oficial,,1,1,2,1,1,2,4,0.407407,0.462121,0,4,0,325,0
ClauTassi,ClauTassi,,0,1,1,0,1,1,2,0.571429,0.625,0,5,0,2160,0
EneideMattos,EneideMattos,,0,1,1,0,1,1,1,1,1,0,50,0,2161,0
LuizS45190481,LuizS45190481,,0,1,1,0,1,1,2,0.666667,0.75,0,50,0,2162,0
VemLutarBrasil,VemLutarBrasil,,0,1,1,0,4,4,1,1,1,0,50,0,2163,0
SantAnnasrSonia,SantAnnasrSonia,,0,1,1,0,1,1,2,0.545455,0.583333,0,0,0,2164,0
AndreaS98127428,AndreaS98127428,,0,1,1,0,2,2,2,0.545455,0.583333,0,10,0,2165,0
Notoroberto,Notoroberto,,0,1,1,0,1,1,1,1,1,0,62,0,2166,0
Rosental,Rosental,,0,1,1,0,1,1,1,1,1,0,152,113,2168,0
JCourses,JCourses,,1,0,1,1,0,1,0,0,0,0,152,113,2167,0
carvalho_ana_,carvalho_ana_,,0,1,1,0,1,1,2,0.571429,0.625,0,5,0,2169,0
jhonleejeronim1,jhonleejeronim1,,0,4,4,0,4,4,1,1,1,0,153,0,2174,0
showdavida,showdavida,,3,0,3,3,0,3,0,0,0,0,153,0,2173,0
Marcos89320515,Marcos89320515,,0,2,2,0,2,2,1,1,1,0,4,0,2175,0.5
edinaldo_olive,edinaldo_olive,,0,1,1,0,1,1,1,1,1,0,219,114,2177,0
BillGates,BillGates,,4,0,4,4,0,4,0,0,0,0,219,114,2176,0.166667
Renatinhagnunes,Renatinhagnunes,,0,1,1,0,1,1,1,1,1,0,25,0,2178,0
LadyCasannova,LadyCasannova,,0,2,2,0,4,4,2,0.583333,0.642857,0,10,0,2179,0
JornalSomos,JornalSomos,,2,0,2,2,0,2,0,0,0,0,0,0,175,0
RejillaT,RejillaT,,0,1,1,0,1,1,1,1,1,0,154,115,2181,0
amazon,amazon,,1,0,1,1,0,1,0,0,0,0,154,115,2180,0
ItamarciaA,ItamarciaA,,0,2,2,0,2,2,1,1,1,0,4,0,2182,0.5
AlepeOficial,AlepeOficial,,0,1,1,0,1,1,1,1,1,0,155,116,2184,0
simonesantanape,simonesantanape,,1,0,1,1,0,1,0,0,0,0,155,116,2183,0
rwturcato,rwturcato,,0,1,1,0,1,1,1,1,1,0,25,0,2185,0
Rodrigues_mazim,Rodrigues_mazim,,0,2,2,0,2,2,1,1,1,0,4,0,2186,0.5
NaraSafreitas,NaraSafreitas,,0,1,1,0,1,1,2,0.571429,0.625,0,5,0,2187,0
cinbarsp,cinbarsp,,0,1,1,0,1,1,2,0.545455,0.583333,0,10,0,2188,0
JorgeLRuiDias,JorgeLRuiDias,,0,1,1,0,1,1,1,1,1,0,62,0,2189,0
Redinei,Redinei,,0,1,1,0,1,1,1,1,1,0,4,0,2190,0
prof_Drica,prof_Drica,,0,2,2,0,2,2,2,0.583333,0.642857,0,10,0,2191,0.5
EDDI6PEDRO,EDDI6PEDRO,,0,1,1,0,1,1,1,1,1,0,58,0,2192,0
cientyfico,cientyfico,,0,1,1,0,1,1,1,1,1,0,29,0,2193,0
ElmaAlmeida,ElmaAlmeida,,0,1,1,0,3,3,2,0.545455,0.583333,0,10,0,2194,0
EMA_News,EMA_News,,1,0,1,1,0,1,0,0,0,0,31,0,276,0
silrosa,silrosa,,0,1,1,0,1,1,2,0.545455,0.583333,0,10,0,2195,0
RICMais_,RICMais_,,2,1,3,5,1,6,1,1,1,0,0,0,174,0.166667
JessicaFradique,JessicaFradique,,0,1,1,0,1,1,2,0.545455,0.583333,0,10,0,2196,0
ruby_roubaix,ruby_roubaix,,0,2,2,0,2,2,2,0.625,0.7,0,286,91,2201,0.5
DoCiclismo,DoCiclismo,,4,4,8,4,4,8,1,1,1,0.000001,286,91,2200,0.071429
TamauPogi,TamauPogi,,4,0,4,4,0,4,0,0,0,0,286,91,2197,0.25
RadioNacionalBR,RadioNacionalBR,,0,1,1,0,1,1,1,1,1,0,62,0,2202,0
PedroPozenato,PedroPozenato,,0,1,1,0,1,1,1,1,1,0,156,117,2204,0
aladilce,aladilce,,3,0,3,3,0,3,0,0,0,0,156,117,2203,0
NiBarga,NiBarga,,0,1,1,0,1,1,1,1,1,0,157,118,2206,0
MultiMidiaInfo,MultiMidiaInfo,,1,0,1,1,0,1,0,0,0,0,157,118,2205,0
linfocitoBTNK,linfocitoBTNK,,0,1,1,0,1,1,1,1,1,0,158,119,2208,0
marylira_98,marylira_98,,6,0,6,6,0,6,0,0,0,0,158,119,2207,0
franciscopfn26,franciscopfn26,,1,0,1,1,0,1,0,0,0,0,0,0,173,0
dudacombr_,dudacombr_,,0,1,1,0,1,1,1,1,1,0,159,120,2210,0
observatorioobr,observatorioobr,,1,0,1,1,0,1,0,0,0,0,159,120,2209,0
alerj,alerj,,0,1,1,0,1,1,1,1,1,0,160,121,2212,0
serafinipsol,serafinipsol,,1,0,1,1,0,1,0,0,0,0,160,121,2211,0
zebedeudascoves,zebedeudascoves,,0,2,2,0,4,4,2,0.666667,0.75,0,62,0,2213,0
adreson,adreson,,0,2,2,0,2,2,1,1,1,0,161,122,2216,0
cathygsouza,cathygsouza,,1,0,1,1,0,1,0,0,0,0,161,122,2215,0
ian_angeli,ian_angeli,,1,0,1,1,0,1,0,0,0,0,161,122,2214,0
JoseDam80359334,JoseDam80359334,,0,1,1,0,1,1,1,1,1,0,58,0,2217,0
leo_mros,leo_mros,,1,1,2,1,1,2,1,1,1,0,0,0,172,0.5
benoitpaire,benoitpaire,,2,0,2,2,0,2,0,0,0,0,0,0,171,0.5
clickciencia,clickciencia,,0,2,2,0,2,2,2,0.666667,0.75,0,76,0,2218,0
prifructis,prifructis,,0,1,1,0,2,2,2,0.545455,0.583333,0,10,0,2219,0
laflalima,laflalima,,0,1,1,0,2,2,1,1,1,0,19,0,2220,0
AugustoNery7,AugustoNery7,,0,1,1,0,1,1,2,0.545455,0.583333,0,10,0,2221,0
Rejamaria,Rejamaria,,0,1,1,0,1,1,2,0.545455,0.583333,0,10,0,2222,0
dani_k,dani_k,,0,1,1,0,1,1,2,0.545455,0.583333,0,10,0,2223,0
Budds_Edu,Budds_Edu,,0,3,3,0,3,3,1,1,1,0,213,0,2225,0
LoucurasDeGenin,LoucurasDeGenin,,0,1,1,0,2,2,1,1,1,0,0,0,2226,0
Daisy36151076,Daisy36151076,,0,2,2,0,2,2,1,1,1,0,125,0,2227,0.5
sitesortimentos,sitesortimentos,,0,1,1,0,1,1,1,1,1,0,162,0,2228,0
sortimentos,sortimentos,,3,0,3,3,0,3,0,0,0,0,162,0,1514,0
GebbegPeople,GebbegPeople,,0,1,1,0,1,1,1,1,1,0,162,0,2229,0
FGV_EAESP,FGV_EAESP,,2,0,2,2,0,2,0,0,0,0,213,0,1437,0
uniao_europeia,uniao_europeia,,1,0,1,1,0,1,0,0,0,0,31,0,275,0
Ativistafemale,Ativistafemale,,0,2,2,0,2,2,1,1,1,0,45,0,2231,0.5
_Cesar_Munoz,_Cesar_Munoz,,1,1,2,1,1,2,1,1,1,0,45,0,2230,0.5
dimilho_slz,dimilho_slz,,0,2,2,0,2,2,2,0.625,0.7,0,286,91,2232,0.5
FernandaAbreud3,FernandaAbreud3,,0,1,1,0,2,2,2,0.545455,0.583333,0,10,0,2233,0
InnovaEnSalud,InnovaEnSalud,,0,1,1,0,1,1,1,1,1,0,29,0,2234,0
Sou_o_Micael,Sou_o_Micael,,0,2,2,0,2,2,2,0.625,0.7,0,286,91,2235,0.5
Nicolas50495323,Nicolas50495323,,0,1,1,0,1,1,1,1,1,0,58,0,2236,0
thuliocsilva,thuliocsilva,,0,1,1,0,1,1,1,1,1,0,0,0,2237,0
RiLadyBee,RiLadyBee,,0,1,1,0,1,1,1,1,1,0,158,119,2238,0
jjaimej,jjaimej,,0,1,1,0,1,1,1,1,1,0,0,0,2239,0
victortamoios,victortamoios,,0,1,1,0,1,1,1,1,1,0,58,0,2240,0
mylou,mylou,,0,1,1,0,1,1,1,1,1,0,76,0,2241,0
TerezaCrisMS,TerezaCrisMS,,2,0,2,2,0,2,0,0,0,0,0,0,170,0.5
igormorais01,igormorais01,,2,0,2,2,0,2,0,0,0,0,0,0,169,0
RibeiroRamosA,RibeiroRamosA,,0,1,1,0,1,1,1,1,1,0,163,123,2243,0
NunoMotaSoares,NunoMotaSoares,,1,0,1,1,0,1,0,0,0,0,163,123,2242,0
DanSantosDan1,DanSantosDan1,,0,1,1,0,1,1,1,1,1,0,58,0,2244,0
FATIMA13eLULA13,FATIMA13eLULA13,,0,2,2,0,2,2,1,1,1,0,45,0,2246,0
caicorn,caicorn,,1,0,1,1,0,1,0,0,0,0,45,0,2245,0
luizhvitorio,luizhvitorio,,0,1,1,0,1,1,1,1,1,0,58,0,2247,0
joaodomenech,joaodomenech,,0,1,1,0,2,2,1,1,1,0,19,0,2248,0
Pollux19531,Pollux19531,,0,1,1,0,1,1,1,1,1,0,29,0,2249,0
aimeedinizk,aimeedinizk,,0,2,2,0,2,2,1,1,1,0,45,0,2250,0.5
LadyBridgertonz,LadyBridgertonz,,0,1,1,0,1,1,1,1,1,0,158,119,2251,0
franklinlimaj,franklinlimaj,,0,2,2,0,2,2,1,1,1,0,45,0,2252,0.5
pcdobbahia65,pcdobbahia65,,0,1,1,0,1,1,1,1,1,0,156,117,2253,0
umaschala,umaschala,,0,1,1,0,1,1,1,1,1,0,164,124,2255,0
aazglr,aazglr,,1,0,1,1,0,1,0,0,0,0,164,124,2254,0
tagsidols,tagsidols,,0,1,1,0,1,1,1,1,1,0,165,125,2257,0
evelynregly,evelynregly,,2,0,2,2,0,2,0,0,0,0,165,125,2256,0
BVFAPESP,BVFAPESP,,1,1,2,1,1,2,2,0.6,0.666667,0,76,0,2139,0.5
FonteBo41711612,FonteBo41711612,,0,2,2,0,2,2,1,1,1,0,4,0,2258,0.5
infoevelynregly,infoevelynregly,,0,1,1,0,1,1,1,1,1,0,165,125,2259,0
OlaMundoIndica,OlaMundoIndica,,1,4,5,3,4,7,1,1,1,0,0,0,168,0.2
operamundi,operamundi,,2,0,2,2,0,2,0,0,0,0,0,0,167,0.5
monicaedfisica,monicaedfisica,,0,1,1,0,1,1,1,1,1,0,19,0,2260,0
IzabelLula,IzabelLula,,0,1,1,0,1,1,2,0.545455,0.583333,0,10,0,2261,0
artistamermo,artistamermo,,0,1,1,0,1,1,1,1,1,0,76,0,2262,0
bkbone,bkbone,,0,1,1,0,1,1,1,1,1,0,58,0,2263,0
canteiro_hugo,canteiro_hugo,,0,1,1,0,1,1,1,1,1,0,58,0,2264,0
Miral59633373,Miral59633373,,0,1,1,0,1,1,1,1,1,0,68,42,2265,0
helena_ansani,helena_ansani,,0,1,1,0,1,1,1,1,1,0,76,0,2266,0
cnnportugal,cnnportugal,,1,0,1,1,0,1,0,0,0,0,48,29,823,0
informasus,informasus,,0,1,1,0,1,1,2,0.666667,0.75,0,76,0,2267,0
JWicktabajara,JWicktabajara,,0,1,1,0,1,1,1,1,1,0,58,0,2268,0
TexugoBadger,TexugoBadger,,0,1,1,0,1,1,1,1,1,0,58,0,2269,0
MNetto14,MNetto14,,0,1,1,0,1,1,1,1,1,0,58,0,2270,0
momisbridger,momisbridger,,0,1,1,0,1,1,1,1,1,0,158,119,2271,0
Matheuseml18,Matheuseml18,,0,2,2,0,2,2,2,0.625,0.7,0,5,0,2272,0
coronazismo,coronazismo,,0,1,1,0,1,1,1,1,1,0,58,0,2273,0
MogKestering,MogKestering,,1,0,1,1,0,1,0,0,0,0,10,0,360,0
UNDPAngola,UNDPAngola,,2,1,3,2,1,3,1,1,1,0,31,0,2274,0
cassiotmurakami,cassiotmurakami,,0,2,2,0,3,3,1,1,1,0,38,0,2275,0
Pivaconservador,Pivaconservador,,1,0,1,4,0,4,0,0,0,0,0,0,166,0
moonysbee,moonysbee,,0,1,1,0,1,1,1,1,1,0,158,119,2276,0
chiccoze52,chiccoze52,,0,2,2,0,2,2,2,0.666667,0.75,0,62,0,2277,0
alonsy_,alonsy_,,0,1,1,0,1,1,2,0.545455,0.583333,0,10,0,2278,0
NoggieVinhos,NoggieVinhos,,0,2,2,0,2,2,2,0.75,0.833333,0,76,0,2280,0
Luc_deOliveira,Luc_deOliveira,,0,1,1,0,1,1,1,1,1,0,76,0,2281,0
forabozonar,forabozonar,,0,2,2,0,4,4,2,0.6,0.666667,0,10,0,2282,0.5
miauhelo,miauhelo,,0,1,1,0,1,1,2,0.545455,0.583333,0,10,0,2283,0
pauloveloso2001,pauloveloso2001,,0,1,1,0,1,1,2,0.6,0.666667,0,8,0,2284,0
mulhergorila,mulhergorila,,0,1,1,0,3,3,2,0.545455,0.583333,0,10,0,2285,0
bvenf,bvenf,,0,1,1,0,1,1,2,0.666667,0.75,0,76,0,2286,0
AnalyBastos,AnalyBastos,,0,1,1,0,1,1,1,1,1,0,76,0,2287,0
frc_vfco,frc_vfco,,0,5,5,0,8,8,3,0.490741,0.525157,0,27,0,2288,0.5
Thelmaccruz,Thelmaccruz,,0,1,1,0,1,1,1,1,1,0,66,0,2289,0
sammillant,sammillant,,0,1,1,0,1,1,1,1,1,0,19,0,2290,0
Julianalopesrj,Julianalopesrj,,0,1,1,0,1,1,1,1,1,0,19,0,2291,0
imirante,imirante,,1,0,1,2,0,2,0,0,0,0,0,0,165,0
OMassamik,OMassamik,,0,1,1,0,1,1,2,0.526316,0.55,0,57,0,2292,0
BethMuhale,BethMuhale,,0,1,1,0,1,1,2,0.666667,0.75,0,166,126,2295,0
UNICEF_Moz,UNICEF_Moz,,5,1,6,5,1,6,1,1,1,0,166,126,2294,0.133333
felipepinho86,felipepinho86,,0,1,1,0,1,1,1,1,1,0,41,0,2296,0
Rafinha42887124,Rafinha42887124,,0,2,2,0,9,9,2,0.6,0.666667,0,10,0,2297,0.5
WladyMello,WladyMello,,1,0,1,1,0,1,0,0,0,0,57,0,406,0
SrtaGBing,SrtaGBing,,0,1,1,0,1,1,1,1,1,0,158,119,2298,0
Raissa_Silva_,Raissa_Silva_,,0,1,1,0,1,1,1,1,1,0,19,0,2299,0
Lauritaarruda,Lauritaarruda,,10,0,10,10,0,10,0,0,0,0,19,0,353,0
butantanoficial,butantanoficial,,2,0,2,5,0,5,0,0,0,0,125,0,463,0
vhcguapo,vhcguapo,,2,2,4,5,2,7,1,1,1,0,0,0,164,0.166667
governope,governope,,2,0,2,2,0,2,0,0,0,0,0,0,163,0.5
ECDC_EU,ECDC_EU,,1,0,1,1,0,1,0,0,0,0,31,0,274,0
RNoticiaz,RNoticiaz,,2,0,2,4,0,4,0,0,0,0,0,0,162,0
Famsfigueira,Famsfigueira,,0,1,1,0,1,1,1,1,1,0,19,0,2300,0
luckvilla,luckvilla,,0,6,6,0,8,8,3,0.495327,0.534591,0,27,0,2301,0.566667
NaeltonMAraujo,NaeltonMAraujo,,0,3,3,0,3,3,1,1,1,0,5,0,2302,0.166667
campos_sanny,campos_sanny,,0,1,1,0,1,1,2,0.545455,0.583333,0,10,0,2303,0
eduardo_spa,eduardo_spa,,0,1,1,0,1,1,1,1,1,0,19,0,2304,0
RabieDimitri,RabieDimitri,,0,1,1,0,3,3,1,1,1,0,22,15,2305,0
MarianinhaGued1,MarianinhaGued1,,0,1,1,0,1,1,2,0.545455,0.583333,0,10,0,2306,0
DINDA_reserva,DINDA_reserva,,0,1,1,0,1,1,2,0.545455,0.583333,0,10,0,2307,0
soniagomes,soniagomes,,0,1,1,0,1,1,1,1,1,0,19,0,2308,0
LizSant95664274,LizSant95664274,,0,1,1,0,1,1,1,1,1,0,19,0,2309,0
israel_lippe,israel_lippe,,0,4,4,0,8,8,2,0.666667,0.75,0,10,0,2310,0.25
andrade_jocelio,andrade_jocelio,,0,2,2,0,2,2,1,1,1,0,125,0,2311,0.5
AtibaiaHoje,AtibaiaHoje,,1,0,1,3,0,3,0,0,0,0,0,0,161,0
waldemariaraujo,waldemariaraujo,,0,1,1,0,1,1,1,1,1,0,19,0,2312,0
ValeriaVilar10,ValeriaVilar10,,0,1,1,0,1,1,1,1,1,0,0,0,2313,0
saudeniteroi,saudeniteroi,,3,0,3,4,0,4,0,0,0,0,0,0,109,0
CoronavirusCD19,CoronavirusCD19,,1,0,1,3,0,3,0,0,0,0,0,0,160,0
redebrasilatual,redebrasilatual,,7,0,7,7,0,7,0,0,0,0,88,0,597,0
wesleyoferreira,wesleyoferreira,,0,1,1,0,1,1,1,1,1,0,167,127,2315,0
BomDespacho_mg,BomDespacho_mg,,2,0,2,2,0,2,0,0,0,0,167,127,2314,0
RonaldodeQue,RonaldodeQue,,0,1,1,0,1,1,1,1,1,0,213,0,2316,0
EmersonDaviB,EmersonDaviB,,0,1,1,0,2,2,1,1,1,0,19,0,2317,0
Yurichrizandro,Yurichrizandro,,0,1,1,0,1,1,1,1,1,0,31,0,2319,0
ACNURAngola,ACNURAngola,,2,0,2,2,0,2,0,0,0,0,31,0,2318,0
alephystera,alephystera,,0,1,1,0,1,1,1,1,1,0,41,0,2320,0
Wyviane,Wyviane,,1,0,1,1,0,1,0,0,0,0,10,0,359,0
InsPaschoarelli,InsPaschoarelli,,0,1,1,0,1,1,2,0.545455,0.583333,0,10,0,2321,0
sbtnews,sbtnews,,14,0,14,28,0,28,0,0,0,0,0,0,159,0.010989
unifesp,unifesp,,0,1,1,0,1,1,1,1,1,0,76,0,2322,0
pfelipe5,pfelipe5,,0,2,2,0,2,2,2,0.583333,0.642857,0,19,0,2323,0
L4RIxis,L4RIxis,,0,1,1,0,1,1,1,1,1,0,19,0,2324,0
Alejandria72,Alejandria72,,0,1,1,0,5,5,1,1,1,0,29,0,2325,0
MoralesRiubi,MoralesRiubi,,0,1,1,0,1,1,1,1,1,0,29,0,2326,0
DokGabyPikoz,DokGabyPikoz,,0,1,1,0,1,1,1,1,1,0,168,128,2328,0
TheDoctorZombie,TheDoctorZombie,,1,0,1,1,0,1,0,0,0,0,168,128,2327,0
gersonnogueira,gersonnogueira,,0,1,1,0,1,1,1,1,1,0,19,0,2329,0
CamiloLiang1,CamiloLiang1,,0,1,1,0,1,1,1,1,1,0,29,0,2330,0
LucineaMariaDe1,LucineaMariaDe1,,0,1,1,0,1,1,2,0.526316,0.55,0,57,0,2331,0
PradoOseias,PradoOseias,,0,1,1,0,1,1,2,0.526316,0.55,0,57,0,2332,0
VeraLuciaHolan3,VeraLuciaHolan3,,0,1,1,0,6,6,1,1,1,0,4,0,2333,0
Rodrigopaz80,Rodrigopaz80,,0,1,1,0,1,1,1,1,1,0,19,0,2334,0
mmadu,mmadu,,0,1,1,0,1,1,2,0.545455,0.583333,0,10,0,2335,0
fbertier,fbertier,,0,1,1,0,1,1,2,0.571429,0.625,0,5,0,2336,0
nembc_official,nembc_official,,1,0,1,1,0,1,0,0,0,0,0,0,158,0
verbrasil2020,verbrasil2020,,0,1,1,0,1,1,2,0.526316,0.55,0,57,0,2337,0
Nathzinha1707,Nathzinha1707,,0,1,1,0,1,1,1,1,1,0,169,129,2339,0
dinizsergio1,dinizsergio1,,1,0,1,1,0,1,0,0,0,0,169,129,2338,0
lulinhares05,lulinhares05,,0,1,1,0,2,2,1,1,1,0,19,0,2340,0
GiseliDornelas,GiseliDornelas,,0,3,3,0,3,3,2,0.615385,0.6875,0,213,0,2341,0
NetoOli49377720,NetoOli49377720,,0,1,1,0,1,1,2,0.526316,0.55,0,57,0,2342,0
Bernardes1Lusa,Bernardes1Lusa,,0,3,3,0,3,3,2,0.588235,0.65,0,57,0,2343,0.333333
tatbarboza,tatbarboza,,0,1,1,0,2,2,1,1,1,0,19,0,2344,0
VBolsonaro22,VBolsonaro22,,2,6,8,2,6,8,1,1,1,0,0,0,157,0.214286
ContaratoSenado,ContaratoSenado,,3,0,3,3,0,3,0,0,0,0,0,0,154,0.333333
senadorhumberto,senadorhumberto,,4,0,4,4,0,4,0,0,0,0,0,0,153,0.166667
ba_aninha,ba_aninha,,0,3,3,0,4,4,3,0.448276,0.538462,0,4,0,2345,0.166667
Marcos_Marcelo_,Marcos_Marcelo_,,0,2,2,0,2,2,1,1,1,0,170,130,2348,0
Madruga2020,Madruga2020,,1,0,1,1,0,1,0,0,0,0,170,130,2347,0
LOC_ADALBERTO,LOC_ADALBERTO,,3,4,7,11,4,15,1,1,1,0,0,0,151,0.119048
PastorLiomar,PastorLiomar,,2,0,2,2,0,2,0,0,0,0,0,0,149,0.5
dorismac64,dorismac64,,0,1,1,0,1,1,1,1,1,0,19,0,2349,0
neuza_paiva,neuza_paiva,,0,1,1,0,1,1,1,1,1,0,171,131,2351,0
Drmarcosbizarro,Drmarcosbizarro,,1,0,1,1,0,1,0,0,0,0,171,131,2350,0
carlagastal,carlagastal,,0,3,3,0,4,4,2,0.615385,0.6875,0,19,0,2352,0
juristadofuturo,juristadofuturo,,0,1,1,0,2,2,2,0.6,0.666667,0,31,0,2353,0
FadaIlha,FadaIlha,,0,1,1,0,1,1,1,1,1,0,19,0,2354,0
marioasouza72,marioasouza72,,0,1,1,0,3,3,1,1,1,0,19,0,2355,0
gnkaos12,gnkaos12,,0,1,1,0,1,1,2,0.545455,0.583333,0,10,0,2356,0
renata_ze,renata_ze,,0,1,1,0,3,3,2,0.545455,0.583333,0,10,0,2357,0
aquijuz,aquijuz,,0,1,1,0,2,2,2,0.545455,0.583333,0,10,0,2358,0
Angela40638513,Angela40638513,,0,1,1,0,1,1,1,1,1,0,19,0,2359,0
CaioFra81146899,CaioFra81146899,,0,1,1,0,1,1,2,0.545455,0.583333,0,10,0,2360,0
arijunior_up,arijunior_up,,0,1,1,0,1,1,1,1,1,0,10,0,2361,0
netoananas,netoananas,,0,1,1,0,1,1,2,0.666667,0.75,0,76,0,2362,0
TooboringStay,TooboringStay,,0,1,1,0,1,1,1,1,1,0,62,0,2363,0
jothwitter,jothwitter,,0,1,1,0,1,1,1,1,1,0,19,0,2364,0
RssPravda,RssPravda,,0,1,1,0,1,1,2,0.666667,0.75,0,76,0,2365,0
marcosmelo47,marcosmelo47,,0,1,1,0,1,1,1,1,1,0,172,132,2367,0
WSarai,WSarai,,2,0,2,2,0,2,0,0,0,0,172,132,2366,0
KellenBrava,KellenBrava,,0,1,1,0,1,1,1,1,1,0,173,133,2369,0
VitaoDebochado,VitaoDebochado,,3,1,4,3,1,4,0,0,0,0,173,133,2368,0.333333
DuhBastos,DuhBastos,,0,1,1,0,1,1,1,1,1,0,19,0,2370,0
augustovasconc,augustovasconc,,0,1,1,0,1,1,1,1,1,0,174,134,2372,0
bancariosbahia,bancariosbahia,,1,0,1,1,0,1,0,0,0,0,174,134,2371,0
sorayabborges,sorayabborges,,0,2,2,0,2,2,2,0.666667,0.75,0,62,0,2373,0
cdef_com_br,cdef_com_br,,1,0,1,1,0,1,0,0,0,0,10,0,358,0
OliviadeMaio1,OliviadeMaio1,,0,1,1,0,1,1,1,1,1,0,88,0,2374,0
Estigiaed,Estigiaed,,0,1,1,0,1,1,1,1,1,0,29,0,2375,0
renatadesouzas,renatadesouzas,,0,1,1,0,1,1,1,1,1,0,19,0,2376,0
vbftavares,vbftavares,,0,2,2,0,2,2,1,1,1,0,125,0,2377,0.5
ernani_neto,ernani_neto,,0,2,2,0,2,2,1,1,1,0,88,0,2378,0
ab_adv,ab_adv,,0,1,1,0,1,1,2,0.545455,0.583333,0,10,0,2379,0
SamuelLernerArq,SamuelLernerArq,,0,1,1,0,1,1,1,1,1,0,19,0,2380,0
VelindaDe,VelindaDe,,0,1,1,0,1,1,1,1,1,0,88,0,2381,0
leonelldourado,leonelldourado,,0,1,1,0,1,1,1,1,1,0,19,0,2382,0
MSOIV,MSOIV,,0,1,1,0,1,1,1,1,1,0,19,0,2383,0
vzleao,vzleao,,0,1,1,0,1,1,1,1,1,0,19,0,2384,0
Time_G_Nao_Sobe,Time_G_Nao_Sobe,,0,1,1,0,1,1,1,1,1,0,19,0,2385,0
cecy12114386,cecy12114386,,0,1,1,0,1,1,1,1,1,0,29,0,2386,0
MarcioRivelino,MarcioRivelino,,0,1,1,0,1,1,1,1,1,0,19,0,2387,0
Lozano_Cloe,Lozano_Cloe,,0,1,1,0,1,1,1,1,1,0,29,0,2388,0
janepeixoto787,janepeixoto787,,0,1,1,0,2,2,1,1,1,0,19,0,2389,0
ElaineRoch,ElaineRoch,,0,1,1,0,1,1,1,1,1,0,19,0,2390,0
GenilPavan,GenilPavan,,0,1,1,0,1,1,1,1,1,0,19,0,2391,0
beatrizcastrope,beatrizcastrope,,0,1,1,0,1,1,1,1,1,0,19,0,2392,0
javaladezm,javaladezm,,0,1,1,0,1,1,1,1,1,0,29,0,2393,0
HazRizoma,HazRizoma,,0,1,1,0,1,1,1,1,1,0,29,0,2394,0
emanuelmendoza1,emanuelmendoza1,,0,1,1,0,1,1,1,1,1,0,29,0,2395,0
jjassol,jjassol,,0,1,1,0,2,2,1,1,1,0,29,0,2396,0
papiabrego,papiabrego,,0,1,1,0,1,1,1,1,1,0,29,0,2397,0
ninha46376081,ninha46376081,,0,1,1,0,2,2,1,1,1,0,62,0,2398,0
Kelkian,Kelkian,,0,1,1,0,1,1,1,1,1,0,29,0,2399,0
gabertoldo,gabertoldo,,0,1,1,0,1,1,1,1,1,0,0,0,2400,0
tvsenado,tvsenado,,4,0,4,5,0,5,0,0,0,0,0,0,124,0
ajrss09,ajrss09,,0,1,1,0,1,1,2,0.545455,0.583333,0,10,0,2401,0
Josrobe79980772,Josrobe79980772,,0,1,1,0,1,1,1,1,1,0,4,0,2402,0
souzafilipecos1,souzafilipecos1,,0,1,1,0,1,1,1,1,1,0,0,0,2403,0
MarciaDVarella,MarciaDVarella,,0,1,1,0,1,1,1,1,1,0,19,0,2404,0
Andricos01,Andricos01,,0,1,1,0,2,2,1,1,1,0,19,0,2405,0
AndreiaRGarcia2,AndreiaRGarcia2,,0,1,1,0,1,1,1,1,1,0,5,0,2406,0
frednavarro,frednavarro,,1,0,1,1,0,1,0,0,0,0,41,0,444,0
AleksyOnat,AleksyOnat,,0,1,1,0,1,1,2,0.545455,0.583333,0,10,0,2407,0
Helenivaldo1,Helenivaldo1,,0,1,1,0,1,1,1,1,1,0,172,132,2408,0
Bia77Antunes,Bia77Antunes,,0,1,1,0,1,1,1,1,1,0,213,0,2409,0
FernandoHortaOf,FernandoHortaOf,,2,0,2,2,0,2,0,0,0,0,0,0,148,0.5
condegustavo,condegustavo,,2,0,2,2,0,2,0,0,0,0,0,0,147,0.5
brasil247,brasil247,,1,0,1,1,0,1,0,0,0,0,0,0,146,0
Zzz72427966,Zzz72427966,,0,1,1,0,1,1,1,1,1,0,213,0,2410,0
betavox,betavox,,0,1,1,0,1,1,2,0.545455,0.583333,0,10,0,2411,0
viveracao,viveracao,,0,1,1,0,1,1,2,0.571429,0.625,0,5,0,2412,0
Brunoaybal,Brunoaybal,,0,1,1,0,1,1,1,1,1,0,41,0,2413,0
AnaLuana_27,AnaLuana_27,,0,1,1,0,1,1,1,1,1,0,62,0,2414,0
RioUsando,RioUsando,,0,3,3,0,3,3,2,0.666667,0.75,0,62,0,2415,0
JACB2021BR,JACB2021BR,,0,3,3,0,3,3,2,0.8,0.875,0,19,0,2416,0
marciojmsilva,marciojmsilva,,0,2,2,0,2,2,1,1,1,0,8,0,2417,0
Hirakawinha,Hirakawinha,,0,1,1,0,1,1,1,1,1,0,175,135,2419,0
camarasaopaulo,camarasaopaulo,,1,0,1,1,0,1,0,0,0,0,175,135,2418,0
DuSupertramp,DuSupertramp,,1,0,1,1,0,1,0,0,0,0,57,0,405,0
adolfo_coelho,adolfo_coelho,,1,0,1,1,0,1,0,0,0,0,57,0,404,0
VeinhoMetal22,VeinhoMetal22,,1,0,1,1,0,1,0,0,0,0,57,0,403,0
valeriascher,valeriascher,,1,0,1,1,0,1,0,0,0,0,57,0,402,0
lcastiglioni81,lcastiglioni81,,0,2,2,0,2,2,2,0.6,0.666667,0,10,0,2420,0.5
Santana13110,Santana13110,,1,0,1,1,0,1,0,0,0,0,12,8,495,0
rubensmenin,rubensmenin,,1,0,1,1,0,1,0,0,0,0,12,8,494,0
lucia98624147,lucia98624147,,0,1,1,0,1,1,2,0.545455,0.583333,0,10,0,2421,0
SilvanaFerrao,SilvanaFerrao,,0,3,3,0,3,3,1,1,1,0,176,136,2425,0.333333
SBeneditoEU,SBeneditoEU,,1,2,3,1,2,3,1,1,1,0,176,136,2424,0.333333
FNyusi,FNyusi,,2,0,2,2,0,2,0,0,0,0,176,136,2423,0.5
JuttaUrpilainen,JuttaUrpilainen,,2,0,2,2,0,2,0,0,0,0,176,136,2422,0.5
claudialyaz,claudialyaz,,0,5,5,0,5,5,3,0.490741,0.525157,0,27,0,2426,0.5
BlogDoTato67,BlogDoTato67,,2,2,4,5,6,11,1,1,1,0,177,137,2428,0.333333
marisamonte,marisamonte,,1,0,1,2,0,2,0,0,0,0,177,137,2427,0
RPG27050264,RPG27050264,,0,1,1,0,1,1,3,0.413793,0.458333,0,4,0,2429,0
daciofarma,daciofarma,,0,2,2,0,2,2,1,1,1,0,19,0,2430,0
marisascruz,marisascruz,,0,1,1,0,1,1,2,0.545455,0.583333,0,10,0,2431,0
endireita_br,endireita_br,,0,1,1,0,1,1,1,1,1,0,5,0,2432,0
TitoGremistazo,TitoGremistazo,,1,1,2,1,1,2,2,0.545455,0.583333,0,80,0,1226,0.5
MarceloACoelho1,MarceloACoelho1,,0,1,1,0,2,2,2,0.545455,0.583333,0,10,0,2433,0
MauroVS,MauroVS,,0,1,1,0,1,1,1,1,1,0,178,138,2435,0
o_antagonista,o_antagonista,,1,0,1,1,0,1,0,0,0,0,178,138,2434,0
edujdowney,edujdowney,,0,4,4,0,4,4,2,0.833333,0.9,0,5,0,2436,0.166667
UNAIDSBrasil,UNAIDSBrasil,,0,2,2,0,3,3,2,0.625,0.7,0,76,0,2437,0
marmor2009,marmor2009,,0,1,1,0,1,1,2,0.545455,0.583333,0,10,0,2438,0
ipirafm,ipirafm,,1,0,1,1,0,1,0,0,0,0,0,0,145,0
FernandaBAragao,FernandaBAragao,,3,1,4,3,1,4,1,1,1,0,179,0,357,0.25
Institutodor,Institutodor,,4,0,4,4,0,4,0,0,0,0,179,0,356,0.25
aquilarcs,aquilarcs,,0,2,2,0,2,2,1,1,1,0,179,0,2439,0.5
teoriantropolog,teoriantropolog,,0,1,1,0,1,1,1,1,1,0,41,0,2440,0
AngolaOnu,AngolaOnu,,0,7,7,0,9,9,2,0.818182,0.888889,0,31,0,2441,0.071429
gustavomachado,gustavomachado,,0,1,1,0,1,1,1,1,1,0,19,0,2442,0
Ro55Javier,Ro55Javier,,0,2,2,0,2,2,1,1,1,0,37,25,2443,0.5
wagnerrod81,wagnerrod81,,0,1,1,0,1,1,1,1,1,0,19,0,2444,0
AnaRuthAlmeida1,AnaRuthAlmeida1,,0,1,1,0,1,1,1,1,1,0,10,0,2445,0
estevesluiz,estevesluiz,,2,0,2,2,0,2,0,0,0,0,10,0,352,0
Indignado72,Indignado72,,0,1,1,0,2,2,1,1,1,0,19,0,2446,0
mamourarj,mamourarj,,0,1,1,0,1,1,1,1,1,0,19,0,2447,0
Thiagosena_bh,Thiagosena_bh,,0,1,1,0,1,1,1,1,1,0,180,139,2449,0
brunnosarttori,brunnosarttori,,1,0,1,1,0,1,0,0,0,0,180,139,2448,0
PauloCruzkilomb,PauloCruzkilomb,,0,1,1,0,1,1,1,1,1,0,19,0,2450,0
EduCosta87,EduCosta87,,0,3,3,0,4,4,1,1,1,0,19,0,2451,0
acusticafm,acusticafm,,1,0,1,1,0,1,0,0,0,0,10,0,355,0
Demisthoclides,Demisthoclides,,0,1,1,0,1,1,1,1,1,0,19,0,2452,0
RafaelLisboa97,RafaelLisboa97,,0,1,1,0,1,1,1,1,1,0,19,0,2453,0
diascynthia,diascynthia,,0,1,1,0,1,1,1,1,1,0,5,0,2454,0
silviacar57,silviacar57,,0,1,1,0,2,2,2,0.545455,0.583333,0,10,0,2455,0
thegcclife,thegcclife,,0,1,1,0,1,1,1,1,1,0,0,0,2456,0
MarceloCariocaX,MarceloCariocaX,,0,1,1,0,1,1,1,1,1,0,181,140,2458,0
VeruskaMazzetto,VeruskaMazzetto,,1,0,1,1,0,1,0,0,0,0,181,140,2457,0
jsemanario,jsemanario,,2,0,2,2,0,2,0,0,0,0,0,0,144,0
Fulana_Luiza,Fulana_Luiza,,0,1,1,0,1,1,2,0.545455,0.583333,0,10,0,2459,0
Juliana06545704,Juliana06545704,,0,1,1,0,1,1,2,0.545455,0.583333,0,10,0,2460,0
gffcavalcante,gffcavalcante,,0,1,1,0,1,1,2,0.666667,0.75,0,76,0,2461,0
Diegozanet1,Diegozanet1,,0,1,1,0,1,1,1,1,1,0,4,0,2462,0
chrisjilvan,chrisjilvan,,2,0,2,2,0,2,0,0,0,0,10,0,354,0
nay_delarocha,nay_delarocha,,0,1,1,0,1,1,1,1,1,0,10,0,2463,0
coimbramariap,coimbramariap,,0,1,1,0,1,1,2,0.545455,0.583333,0,10,0,2464,0
Lu13Luiza,Lu13Luiza,,0,1,1,0,1,1,2,0.545455,0.583333,0,10,0,2465,0
TioLaser,TioLaser,,0,1,1,0,1,1,2,0.545455,0.583333,0,10,0,2466,0
EuRobo36,EuRobo36,,0,2,2,0,2,2,2,0.666667,0.75,0,62,0,2467,0
AlexBrazilZone,AlexBrazilZone,,0,1,1,0,1,1,1,1,1,0,4,0,2468,0
Ninanina1215,Ninanina1215,,0,1,1,0,1,1,1,1,1,0,262,141,2470,0
alex_pirlowski,alex_pirlowski,,3,0,3,4,0,4,0,0,0,0,262,141,2469,0
ivic00633480,ivic00633480,,0,1,1,0,1,1,1,1,1,0,262,141,2471,0
SergioF11104047,SergioF11104047,,0,2,2,0,3,3,1,1,1,0,38,0,2472,0
cleiton_d7,cleiton_d7,,0,1,1,0,1,1,1,1,1,0,4,0,2473,0
Alizon_iv,Alizon_iv,,0,1,1,0,1,1,1,1,1,0,0,0,2474,0
franklinsollo,franklinsollo,,0,1,1,0,1,1,1,1,1,0,5,0,2475,0
CarlaMarquesz,CarlaMarquesz,,0,1,1,0,1,1,2,0.666667,0.75,0,76,0,2476,0
GRQM,GRQM,,0,2,2,0,5,5,2,0.666667,0.75,0,62,0,2477,0
koudaiin,koudaiin,,0,1,1,0,1,1,1,1,1,0,19,0,2478,0
Vidama57,Vidama57,,0,1,1,0,1,1,1,1,1,0,19,0,2479,0
bdbott,bdbott,,0,1,1,0,1,1,1,1,1,0,167,127,2480,0
e_preparando,e_preparando,,0,1,1,0,1,1,1,1,1,0,4,0,2481,0
GuerreiroPatr10,GuerreiroPatr10,,0,1,1,0,1,1,1,1,1,0,4,0,2482,0
museudavida,museudavida,,0,1,1,0,1,1,2,0.666667,0.75,0,76,0,2483,0
IvanValente,IvanValente,,2,0,2,3,0,3,0,0,0,0,27,0,85,1
jackieroos475,jackieroos475,,0,2,2,0,2,2,2,0.571429,0.625,0,31,0,2485,0
JustinTrudeau,JustinTrudeau,,1,0,1,1,0,1,0,0,0,0,31,0,2484,0
eduheyx,eduheyx,,0,1,1,0,1,1,2,0.666667,0.75,0,76,0,2486,0
AmazoninoAM,AmazoninoAM,,1,0,1,1,0,1,0,0,0,0,10,0,351,0
livingforart,livingforart,,0,1,1,0,1,1,1,1,1,0,182,142,2488,0
resolvarapido,resolvarapido,,1,0,1,1,0,1,0,0,0,0,182,142,2487,0
gutembergdias,gutembergdias,,0,1,1,0,1,1,1,1,1,0,19,0,2489,0
stylesjmin,stylesjmin,,0,2,2,0,5,5,2,0.666667,0.75,0,62,0,2490,0
conasems,conasems,,0,1,1,0,1,1,1,1,1,0,4,0,2491,0
FIGroupBR,FIGroupBR,,0,1,1,0,1,1,1,1,1,0,183,143,2493,0
camaradeputados,camaradeputados,,1,0,1,1,0,1,0,0,0,0,183,143,2492,0
Marceloprof88,Marceloprof88,,0,1,1,0,1,1,1,1,1,0,73,0,2494,0
Fernandimmed,Fernandimmed,,0,3,3,0,3,3,2,0.714286,0.8,0,62,0,2495,0
BibliotecaFCM,BibliotecaFCM,,0,3,3,0,3,3,2,0.615385,0.6875,0,76,0,2496,0
CP2_oficial,CP2_oficial,,2,0,2,2,0,2,0,0,0,0,0,0,143,0.5
Hudsonrpd,Hudsonrpd,,0,1,1,0,1,1,1,1,1,0,19,0,2497,0
GovernoMadeira,GovernoMadeira,,1,0,1,1,0,1,0,0,0,0,31,0,273,0
EmFonseca1,EmFonseca1,,0,1,1,0,1,1,1,1,1,0,184,144,2499,0
SRaimundo0,SRaimundo0,,1,0,1,1,0,1,0,0,0,0,184,144,2498,0
idolatrianao,idolatrianao,,0,1,1,0,1,1,2,0.545455,0.583333,0,10,0,2500,0
CienciaHoje,CienciaHoje,,0,1,1,0,1,1,2,0.666667,0.75,0,76,0,2501,0
Ross_Villasboa,Ross_Villasboa,,0,1,1,0,1,1,1,1,1,0,185,145,2503,0
carolsmoreiraa,carolsmoreiraa,,2,0,2,2,0,2,0,0,0,0,185,145,2502,0
HelenaMota9,HelenaMota9,,2,0,2,2,0,2,0,0,0,0,20,0,386,1
laurinhapoa,laurinhapoa,,0,1,1,0,1,1,2,0.6,0.666667,0,31,0,2504,0
HajaHope,HajaHope,,0,1,1,0,1,1,1,1,1,0,5,0,2505,0
CICV_pt,CICV_pt,,0,1,1,0,1,1,1,1,1,0,5,0,2506,0
neuro_pod,neuro_pod,,0,2,2,0,2,2,1,1,1,0,179,0,2507,0.5
MarceloBR21,MarceloBR21,,0,2,2,0,2,2,2,0.666667,0.75,0,62,0,2508,0
lubrial,lubrial,,0,1,1,0,1,1,1,1,1,0,186,146,2510,0
BahiaNoticias,BahiaNoticias,,1,0,1,1,0,1,0,0,0,0,186,146,2509,0
stefany_carli,stefany_carli,,0,3,3,0,3,3,2,0.714286,0.8,0,88,0,2511,0
uerjdadepressao,uerjdadepressao,,0,1,1,0,1,1,2,0.666667,0.75,0,0,0,2512,0
jbns_top,jbns_top,,0,1,1,0,1,1,1,1,1,0,19,0,2513,0
luciaalves404,luciaalves404,,0,2,2,0,2,2,1,1,1,0,125,0,2514,0.5
FelisRoberto,FelisRoberto,,0,2,2,0,2,2,2,0.666667,0.75,0,62,0,2515,0
Bri_Meads,Bri_Meads,,0,1,1,0,1,1,1,1,1,0,187,147,2517,0
Kevin_Maguire,Kevin_Maguire,,1,0,1,1,0,1,0,0,0,0,187,147,2516,0
SilvaniaCarli,SilvaniaCarli,,0,1,1,0,1,1,2,0.545455,0.583333,0,10,0,2518,0
Claudet72026317,Claudet72026317,,0,2,2,0,2,2,1,1,1,0,125,0,2519,0.5
olivalucasof,olivalucasof,,0,1,1,0,1,1,1,1,1,0,19,0,2520,0
MaibonSimone,MaibonSimone,,0,1,1,0,1,1,2,0.545455,0.583333,0,0,0,2521,0
fora_miliciano,fora_miliciano,,0,2,2,0,2,2,1,1,1,0,188,148,2524,0
__redeglobo,__redeglobo,,1,0,1,1,0,1,0,0,0,0,188,148,2523,0
AfonsoCAr_,AfonsoCAr_,,0,1,1,0,1,1,1,1,1,0,189,149,2526,0
duartep84,duartep84,,1,0,1,1,0,1,0,0,0,0,189,149,2525,0
jogodopodermn_,jogodopodermn_,,1,0,1,1,0,1,0,0,0,0,1,1,436,0
ananiasribeiro,ananiasribeiro,,1,0,1,2,0,2,0,0,0,0,1,1,435,0
amadeucampospi,amadeucampospi,,1,0,1,2,0,2,0,0,0,0,1,1,434,0
catarinabento99,catarinabento99,,0,1,1,0,1,1,1,1,1,0,8,0,2527,0
Adalva12,Adalva12,,0,2,2,0,2,2,1,1,1,0,125,0,2528,0.5
Marina_Lapin20,Marina_Lapin20,,0,1,1,0,8,8,2,0.545455,0.583333,0,10,0,2529,0
mendes_zilma,mendes_zilma,,0,2,2,0,2,2,1,1,1,0,5,0,2530,0.5
DAzevedo10,DAzevedo10,,0,2,2,0,3,3,2,0.6,0.666667,0,10,0,2531,0.5
VitorMMoreira1,VitorMMoreira1,,0,2,2,0,3,3,2,0.666667,0.75,0,62,0,2532,0
AlexandreGeren5,AlexandreGeren5,,0,2,2,0,2,2,2,0.666667,0.75,0,62,0,2533,0
jamszeca,jamszeca,,0,1,1,0,1,1,1,1,1,0,190,150,2535,0
smabc,smabc,,1,0,1,1,0,1,0,0,0,0,190,150,2534,0
JohnNoizz,JohnNoizz,,0,1,1,0,1,1,1,1,1,0,185,145,2536,0
Fapohi_mce,Fapohi_mce,,0,1,1,0,1,1,1,1,1,0,29,0,2537,0
mribeirodantas,mribeirodantas,,0,1,1,0,1,1,1,1,1,0,191,151,2539,0
brenos_mtb,brenos_mtb,,1,0,1,1,0,1,0,0,0,0,191,151,2538,0
grupo_infovid,grupo_infovid,,0,2,2,0,2,2,1,1,1,0,62,0,2540,0
PedroGiovany,PedroGiovany,,0,2,2,0,2,2,1,1,1,0,192,152,2543,0
decamargomoises,decamargomoises,,1,0,1,1,0,1,0,0,0,0,192,152,2542,0
EdmirChedid,EdmirChedid,,1,0,1,1,0,1,0,0,0,0,192,152,2541,0
fentysb,fentysb,,0,1,1,0,1,1,1,1,1,0,4,0,2544,0
MarciaBia,MarciaBia,,0,1,1,0,1,1,2,0.6,0.666667,0,76,0,2545,0
nunosilva79pt,nunosilva79pt,,0,1,1,0,1,1,2,0.515152,0.529412,0,20,0,2546,0
telmaoak,telmaoak,,0,1,1,0,1,1,1,1,1,0,4,0,2547,0
1RICARDOCARDOSO,1RICARDOCARDOSO,,0,2,2,0,2,2,2,0.666667,0.75,0,62,0,2548,0
Daniel_Morais_B,Daniel_Morais_B,,0,2,2,0,2,2,2,0.75,0.833333,0,71,0,2549,0.5
resonances,resonances,,0,1,1,0,1,1,2,0.6,0.666667,0,76,0,2550,0
cpereiracon,cpereiracon,,0,1,1,0,1,1,2,0.666667,0.75,0,62,0,2551,0
SirleiFlesch,SirleiFlesch,,0,4,4,0,4,4,1,1,1,0,115,0,2552,0.083333
MuriloSalviano,MuriloSalviano,,27,0,27,27,0,27,0,0,0,0,115,0,343,0.037037
instEmilioRibas,instEmilioRibas,,26,0,26,26,0,26,0,0,0,0,115,0,342,0
CanadanoBrasil,CanadanoBrasil,,0,1,1,0,1,1,1,1,1,0,193,153,2554,0
gavi,gavi,,1,0,1,1,0,1,0,0,0,0,193,153,2553,0
timbaoepuma,timbaoepuma,,0,1,1,0,1,1,2,0.6,0.666667,0,76,0,2555,0
Gremlinanger,Gremlinanger,,0,2,2,0,2,2,1,1,1,0,87,55,2556,0.5
EltonValentim76,EltonValentim76,,0,1,1,0,1,1,1,1,1,0,194,154,2558,0
Ana_aparecida_,Ana_aparecida_,,1,0,1,1,0,1,0,0,0,0,194,154,2557,0
EdoStork,EdoStork,,0,1,1,0,1,1,2,0.666667,0.75,0,31,0,2559,0
FasRobespierre,FasRobespierre,,0,1,1,0,1,1,1,1,1,0,195,155,2561,0
Guilhotinainfo,Guilhotinainfo,,1,0,1,1,0,1,0,0,0,0,195,155,2560,0
FRocha70330878,FRocha70330878,,0,1,1,0,1,1,2,0.545455,0.583333,0,10,0,2562,0
RedeGlobo9,RedeGlobo9,,1,0,1,1,0,1,0,0,0,0,188,148,2522,0
dircilenee,dircilenee,,0,1,1,0,1,1,2,0.545455,0.583333,0,10,0,2563,0
felicidadeEluta,felicidadeEluta,,0,1,1,0,1,1,2,0.545455,0.583333,0,10,0,2564,0
BerlengasOrg,BerlengasOrg,,0,1,1,0,1,1,1,1,1,0,0,0,2565,0
abunelli55,abunelli55,,0,1,1,0,1,1,1,1,1,0,196,156,2567,0
mazaccaron,mazaccaron,,3,0,3,3,0,3,0,0,0,0,196,156,2566,0
SRONALDO,SRONALDO,,0,1,1,0,1,1,1,1,1,0,196,156,2568,0
eusemsereu,eusemsereu,,0,1,1,0,1,1,1,1,1,0,197,157,2570,0
eristonmattos,eristonmattos,,1,0,1,1,0,1,0,0,0,0,197,157,2569,0
MariaIs35076534,MariaIs35076534,,0,2,2,0,2,2,2,0.666667,0.75,0,62,0,2571,0
Digo23832622,Digo23832622,,0,2,2,0,2,2,2,0.583333,0.642857,0,213,0,2572,0
HiramAlvim,HiramAlvim,,0,1,1,0,1,1,1,1,1,0,196,156,2573,0
ONUMulheresBR,ONUMulheresBR,,2,0,2,2,0,2,0,0,0,0,76,0,1171,0
lica_anjo,lica_anjo,,0,1,1,0,1,1,2,0.545455,0.583333,0,10,0,2574,0
FABIOAGUAYO,FABIOAGUAYO,,0,1,1,0,1,1,3,0.413793,0.458333,0,4,0,2575,0
amilhaum,amilhaum,,0,2,2,0,2,2,2,0.666667,0.75,0,62,0,2576,0
governomg,governomg,,1,1,2,2,3,5,1,1,1,0,0,0,1965,0.5
VilsonC89670678,VilsonC89670678,,0,2,2,0,2,2,2,0.666667,0.75,0,62,0,2577,0
geraldopost,geraldopost,,0,1,1,0,1,1,2,0.571429,0.625,0,5,0,2578,0
PeterMr,PeterMr,,0,2,2,0,2,2,2,0.583333,0.642857,0,10,0,2579,0
maryannabinder,maryannabinder,,0,2,2,0,2,2,2,0.666667,0.75,0,62,0,2580,0
CMSesimbra,CMSesimbra,,0,1,1,0,1,1,1,1,1,0,8,0,2581,0
Gisele_MS2,Gisele_MS2,,0,3,3,0,4,4,2,0.714286,0.8,0,62,0,2582,0
raissaebrahim,raissaebrahim,,0,1,1,0,1,1,1,1,1,0,10,0,2583,0
PradoPecci,PradoPecci,,0,1,1,0,1,1,2,0.6,0.666667,0,76,0,2584,0
valenteteacher,valenteteacher,,0,1,1,0,1,1,1,1,1,0,27,0,2585,0
pombozap,pombozap,,0,1,1,0,1,1,2,0.545455,0.583333,0,10,0,2586,0
ecodebate,ecodebate,,0,1,1,0,1,1,2,0.545455,0.583333,0,10,0,2587,0
nuncaabandona,nuncaabandona,,0,1,1,0,1,1,2,0.6,0.666667,0,76,0,2588,0
ramoom13,ramoom13,,0,3,3,0,3,3,2,0.615385,0.6875,0,76,0,2589,0.333333
paulaum1986,paulaum1986,,0,1,1,0,1,1,1,1,1,0,198,158,2591,0
dagobertopdt,dagobertopdt,,1,0,1,1,0,1,0,0,0,0,198,158,2590,0
luduvicu,luduvicu,,0,1,1,0,1,1,2,0.6,0.666667,0,76,0,2592,0
CarlosBolzan2,CarlosBolzan2,,0,2,2,0,2,2,1,1,1,0,81,50,2593,0
semuspalmas,semuspalmas,,0,2,2,0,2,2,1,1,1,0,84,0,2594,1
cidadepalmas,cidadepalmas,,4,2,6,4,2,6,1,1,1,0,84,0,379,0.5
FabiaMazza,FabiaMazza,,0,1,1,0,1,1,2,0.545455,0.583333,0,10,0,2595,0
messblog,messblog,,0,1,1,0,2,2,2,0.545455,0.583333,0,10,0,2596,0
milagre_horto,milagre_horto,,0,1,1,0,1,1,2,0.545455,0.583333,0,10,0,2597,0
elisnunes1,elisnunes1,,0,1,1,0,1,1,1,1,1,0,46,0,2598,0
sxpolitics,sxpolitics,,0,1,1,0,1,1,1,1,1,0,5,0,2599,0
ericolpp,ericolpp,,0,1,1,0,1,1,2,0.6,0.666667,0,76,0,2600,0
AnninhaGraca,AnninhaGraca,,0,1,1,0,1,1,1,1,1,0,199,159,2602,0
daniela_sgt,daniela_sgt,,1,0,1,1,0,1,0,0,0,0,199,159,2601,0
agostinho1979,agostinho1979,,0,2,2,0,2,2,1,1,1,0,84,0,2603,1
DanielaLucio_,DanielaLucio_,,0,2,2,0,2,2,1,1,1,0,38,0,2604,0
thiagorleao13,thiagorleao13,,0,1,1,0,1,1,2,0.545455,0.583333,0,10,0,2605,0
IsisM1985,IsisM1985,,0,1,1,0,1,1,1,1,1,0,19,0,2606,0
omarceloaguiar,omarceloaguiar,,0,1,1,0,1,1,1,1,1,0,19,0,2607,0
aacamerano,aacamerano,,0,1,1,0,1,1,1,1,1,0,200,160,2609,0
bireme,bireme,,1,0,1,1,0,1,0,0,0,0,200,160,2608,0
evelinthesite,evelinthesite,,0,1,1,0,1,1,2,0.545455,0.583333,0,10,0,2610,0
revComCiencia,revComCiencia,,0,1,1,0,1,1,2,0.6,0.666667,0,76,0,2611,0
Oxe_imp,Oxe_imp,,0,1,1,0,1,1,2,0.545455,0.583333,0,10,0,2612,0
CidadeParaiba,CidadeParaiba,,4,1,5,5,1,6,1,1,1,0,147,0,348,0.05
camarajp,camarajp,,2,0,2,3,0,3,0,0,0,0,147,0,347,0.5
callado_ros,callado_ros,,0,2,2,0,2,2,2,0.666667,0.75,0,62,0,2613,0
biatoscano_,biatoscano_,,0,1,1,0,1,1,2,0.666667,0.75,0,76,0,2614,0
lenna_tuita,lenna_tuita,,0,1,1,0,1,1,1,1,1,0,201,161,2616,0
P_Enfermagem,P_Enfermagem,,1,0,1,1,0,1,0,0,0,0,201,161,2615,0
none23588,none23588,,0,1,1,0,1,1,1,1,1,0,71,0,2617,0
Alexandre98434,Alexandre98434,,0,1,1,0,2,2,2,0.545455,0.583333,0,10,0,2618,0
Sheyla181261,Sheyla181261,,0,1,1,0,1,1,2,0.545455,0.583333,0,10,0,2619,0
Bry_FelHer,Bry_FelHer,,0,1,1,0,1,1,1,1,1,0,29,0,2620,0
najla_cerquinho,najla_cerquinho,,0,1,1,0,1,1,1,1,1,0,5,0,2621,0
romulomafra,romulomafra,,0,2,2,0,2,2,2,0.666667,0.75,0,62,0,2622,0
MarNaoSereno,MarNaoSereno,,0,2,2,0,2,2,2,0.666667,0.75,0,62,0,2623,0
hopeluta_,hopeluta_,,0,3,3,0,3,3,2,0.714286,0.8,0,62,0,2625,0
Palavdiversas,Palavdiversas,,1,0,1,1,0,1,0,0,0,0,62,0,2624,0
fizziefb,fizziefb,,0,1,1,0,2,2,2,0.545455,0.583333,0,10,0,2626,0
YuriBachir,YuriBachir,,0,1,1,0,1,1,2,0.545455,0.583333,0,10,0,2627,0
thunder_rafael,thunder_rafael,,0,2,2,0,2,2,2,0.6,0.666667,0,10,0,2628,0.5
serialtavares,serialtavares,,0,1,1,0,1,1,2,0.545455,0.583333,0,10,0,2629,0
ericofilipe,ericofilipe,,0,2,2,0,2,2,1,1,1,0,4,0,2630,0.5
saarapinheiro,saarapinheiro,,0,1,1,0,2,2,2,0.545455,0.583333,0,10,0,2631,0
anarussi_,anarussi_,,0,1,1,0,1,1,1,1,1,0,76,0,2632,0
GlenValente,GlenValente,,0,2,2,0,2,2,1,1,1,0,4,0,2633,0.5
canaes_silvia,canaes_silvia,,0,1,1,0,1,1,2,0.545455,0.583333,0,10,0,2634,0
abegabe701,abegabe701,,0,1,1,0,1,1,1,1,1,0,29,0,2635,0
breaczouis,breaczouis,,0,2,2,0,2,2,2,0.625,0.7,0,5,0,2636,0
Wasana02293527,Wasana02293527,,0,2,2,0,2,2,2,0.666667,0.75,0,62,0,2637,0
CezarAlmeida18,CezarAlmeida18,,0,2,2,0,2,2,1,1,1,0,4,0,2638,0.5
zildo_vicente,zildo_vicente,,0,2,2,0,2,2,1,1,1,0,4,0,2639,0.5
MarciaCSS71,MarciaCSS71,,0,1,1,0,1,1,1,1,1,0,73,0,2640,0
rubensmidt,rubensmidt,,0,3,3,0,3,3,3,0.571429,0.666667,0,5,0,2641,0.166667
JunqueiraWilian,JunqueiraWilian,,0,1,1,0,1,1,1,1,1,0,173,133,2642,0
LucieneAOca,LucieneAOca,,0,1,1,0,5,5,2,0.545455,0.583333,0,10,0,2643,0
PortalCNoticia,PortalCNoticia,,0,2,2,0,2,2,1,1,1,0,81,50,2644,0
lilacarol,lilacarol,,1,0,1,1,0,1,0,0,0,0,10,0,349,0
PateBacurauense,PateBacurauense,,0,3,3,0,5,5,2,0.666667,0.75,0,10,0,2645,0.666667
RodrigoBiomedi,RodrigoBiomedi,,0,2,2,0,3,3,2,0.6,0.666667,0,10,0,2646,0.5
educadf,educadf,,2,0,2,2,0,2,0,0,0,0,0,0,140,0.5
FLORAGOMES,FLORAGOMES,,0,3,3,0,3,3,3,0.48,0.569444,0,4,0,2647,0.166667
SrtaCarneiro01,SrtaCarneiro01,,0,1,1,0,1,1,2,0.666667,0.75,0,147,0,2648,0
mauriliopasqui2,mauriliopasqui2,,0,2,2,0,6,6,2,0.666667,0.75,0,62,0,2649,0
nadiabambirra,nadiabambirra,,0,2,2,0,2,2,2,0.6,0.666667,0,10,0,2650,0.5
DragoGuerreiro3,DragoGuerreiro3,,0,1,1,0,1,1,1,1,1,0,19,0,2651,0
nhmaruyama,nhmaruyama,,0,2,2,0,3,3,2,0.6,0.666667,0,10,0,2652,0.5
jussaalonso,jussaalonso,,0,1,1,0,1,1,2,0.545455,0.583333,0,10,0,2653,0
lipido,lipido,,0,1,1,0,1,1,1,1,1,0,10,0,2654,0
prazapublica,prazapublica,,3,0,3,3,0,3,0,0,0,0,10,0,346,0
noelitalebi,noelitalebi,,0,1,1,0,1,1,1,1,1,0,19,0,2655,0
DayOliv79390795,DayOliv79390795,,1,0,1,2,0,2,0,0,0,0,5,0,710,0
MariaBordin2,MariaBordin2,,0,2,2,0,2,2,2,0.75,0.833333,0,71,0,2656,0.5
Michell15303291,Michell15303291,,0,2,2,0,2,2,2,0.666667,0.75,0,62,0,2657,0
pavarini,pavarini,,0,1,1,0,1,1,1,1,1,0,202,162,2659,0
JudithAlm,JudithAlm,,1,0,1,1,0,1,0,0,0,0,202,162,2658,0
MarceloPintoBA,MarceloPintoBA,,0,2,2,0,4,4,2,0.666667,0.75,0,62,0,2660,0
4narc0,4narc0,,0,1,1,0,3,3,2,0.545455,0.583333,0,10,0,2661,0
DVensao,DVensao,,0,2,2,0,3,3,2,0.75,0.833333,0,71,0,2662,0.5
GomesOliveira5,GomesOliveira5,,0,1,1,0,1,1,2,0.545455,0.583333,0,10,0,2663,0
luis_mascarello,luis_mascarello,,0,3,3,0,3,3,1,1,1,0,125,0,2664,0.166667
LuizCoutoES,LuizCoutoES,,0,3,3,0,4,4,3,0.545455,0.611111,0,4,0,2665,0.5
FiLooSoPhiia,FiLooSoPhiia,,0,1,1,0,1,1,2,0.545455,0.583333,0,10,0,2666,0
jcerodrigues,jcerodrigues,,0,3,3,0,3,3,1,1,1,0,115,0,2667,0.166667
mi_rodriguesz,mi_rodriguesz,,0,1,1,0,1,1,2,0.545455,0.583333,0,10,0,2668,0
FAECURY,FAECURY,,0,2,2,0,3,3,2,0.6,0.666667,0,10,0,2669,0.5
rfsegatto,rfsegatto,,0,2,2,0,2,2,2,0.6,0.666667,0,10,0,2670,0.5
namiclips,namiclips,,0,2,2,0,2,2,2,0.666667,0.75,0,62,0,2671,0
arte_prima,arte_prima,,0,1,1,0,2,2,2,0.545455,0.583333,0,10,0,2672,0
luizmarinhosiv,luizmarinhosiv,,0,1,1,0,1,1,2,0.666667,0.75,0,147,0,2673,0
palavrissima,palavrissima,,0,1,1,0,1,1,2,0.545455,0.583333,0,10,0,2674,0
senhorita_p,senhorita_p,,0,1,1,0,1,1,2,0.545455,0.583333,0,10,0,2675,0
ComsensoWeb,ComsensoWeb,,0,2,2,0,2,2,1,1,1,0,203,163,2678,0
twpris_reporter,twpris_reporter,,1,0,1,1,0,1,0,0,0,0,203,163,2677,0
saudearacaju,saudearacaju,,1,0,1,1,0,1,0,0,0,0,203,163,2676,0
HXerozo11,HXerozo11,,0,2,2,0,2,2,2,0.666667,0.75,0,62,0,2679,0
EveMarBR,EveMarBR,,0,3,3,0,3,3,1,1,1,0,115,0,2680,0.166667
jonh900,jonh900,,0,2,2,0,4,4,2,0.666667,0.75,0,62,0,2681,0
EricWal03730092,EricWal03730092,,0,3,3,0,3,3,1,1,1,0,110,76,2683,0.166667
DouglasGarcia,DouglasGarcia,,1,0,1,1,0,1,0,0,0,0,110,76,2682,0
riporip,riporip,,0,1,1,0,1,1,1,1,1,0,73,0,2684,0
glaurungsx,glaurungsx,,0,2,2,0,4,4,2,0.666667,0.75,0,62,0,2685,0
Pedrinhoslive,Pedrinhoslive,,0,2,2,0,3,3,3,0.428571,0.5,0,4,0,2686,0.5
drica_salam,drica_salam,,0,1,1,0,2,2,2,0.545455,0.583333,0,10,0,2687,0
jufrlima,jufrlima,,0,3,3,0,3,3,1,1,1,0,115,0,2688,0.166667
DemocraciaMZ,DemocraciaMZ,,0,2,2,0,2,2,1,1,1,0,204,164,2691,0.5
verdademz,verdademz,,1,1,2,1,1,2,1,1,1,0,204,164,2690,0.5
voeLAM,voeLAM,,2,0,2,2,0,2,0,0,0,0,204,164,2689,0.5
Soares9Sandro,Soares9Sandro,,0,1,1,0,1,1,1,1,1,0,4,0,2692,0
staylleida,staylleida,,0,1,1,0,1,1,1,1,1,0,71,0,2693,0
lena_patty,lena_patty,,0,1,1,0,1,1,1,1,1,0,19,0,2694,0
Marino1Manuel,Marino1Manuel,,0,1,1,0,1,1,1,1,1,0,29,0,2695,0
EdnaFavaretto,EdnaFavaretto,,0,1,1,0,1,1,1,1,1,0,4,0,2696,0
eldapianista,eldapianista,,0,1,1,0,1,1,1,1,1,0,73,0,2697,0
MiLick74,MiLick74,,0,2,2,0,2,2,1,1,1,0,73,0,2698,0
PORT0_89,PORT0_89,,0,1,1,0,1,1,1,1,1,0,73,0,2699,0
lucianoamorim94,lucianoamorim94,,0,1,1,0,1,1,1,1,1,0,19,0,2700,0
helberaraujo,helberaraujo,,0,1,1,0,1,1,2,0.545455,0.583333,0,10,0,2701,0
LMC240570,LMC240570,,0,4,4,0,7,7,2,0.666667,0.75,0,10,0,2702,0.083333
cmendeschaves,cmendeschaves,,0,1,1,0,1,1,1,1,1,0,73,0,2703,0
JussaraPerea,JussaraPerea,,0,3,3,0,3,3,1,1,1,0,115,0,2704,0.166667
tecmonte,tecmonte,,0,1,1,0,1,1,1,1,1,0,73,0,2705,0
Hustenk,Hustenk,,0,2,2,0,3,3,2,0.666667,0.75,0,62,0,2706,0
ameliaconta2,ameliaconta2,,0,2,2,0,2,2,2,0.666667,0.75,0,62,0,2707,0
BibiRamrez3,BibiRamrez3,,0,1,1,0,1,1,1,1,1,0,29,0,2708,0
luis_claudioss,luis_claudioss,,0,1,1,0,1,1,1,1,1,0,19,0,2709,0
EdmilsonFCFilho,EdmilsonFCFilho,,0,1,1,0,1,1,2,0.545455,0.583333,0,10,0,2710,0
AElizabethVS,AElizabethVS,,0,1,1,0,1,1,1,1,1,0,29,0,2711,0
valmirgs,valmirgs,,0,1,1,0,1,1,1,1,1,0,19,0,2712,0
DaniFreireCosta,DaniFreireCosta,,0,2,2,0,5,5,2,0.666667,0.75,0,62,0,2713,0
Fapessone,Fapessone,,0,1,1,0,1,1,1,1,1,0,73,0,2714,0
fernandoaug5,fernandoaug5,,0,1,1,0,1,1,1,1,1,0,73,0,2715,0
mfecha,mfecha,,0,1,1,0,1,1,1,1,1,0,73,0,2716,0
wrodrigues_app4,wrodrigues_app4,,0,1,1,0,1,1,1,1,1,0,73,0,2717,0
joaquimmonstrao,joaquimmonstrao,,3,0,3,4,0,4,0,0,0,0,0,0,139,0.333333
TheKrakenMX,TheKrakenMX,,0,1,1,0,1,1,1,1,1,0,29,0,2718,0
Dir_Guillermoso,Dir_Guillermoso,,0,1,1,0,1,1,1,1,1,0,29,0,2719,0
CarlosSirotheau,CarlosSirotheau,,0,1,1,0,1,1,1,1,1,0,73,0,2720,0
monteironews1,monteironews1,,0,2,2,0,2,2,1,1,1,0,19,0,2721,0
ViniMiguel23,ViniMiguel23,,0,2,2,0,2,2,2,0.666667,0.75,0,62,0,2722,0
AneFaria4,AneFaria4,,0,1,1,0,1,1,1,1,1,0,73,0,2723,0
oobservadorbr,oobservadorbr,,0,3,3,0,3,3,1,1,1,0,115,0,2724,0.166667
xOJeffersonOx,xOJeffersonOx,,0,1,1,0,1,1,1,1,1,0,205,165,2726,0
majucoutinho,majucoutinho,,1,0,1,1,0,1,0,0,0,0,205,165,2725,0
PauloMozzone,PauloMozzone,,0,1,1,0,1,1,1,1,1,0,19,0,2727,0
odaoliver,odaoliver,,0,1,1,0,1,1,1,1,1,0,73,0,2728,0
lkwjlwkdl,lkwjlwkdl,,0,1,1,0,1,1,1,1,1,0,73,0,2729,0
MMaggal,MMaggal,,0,1,1,0,1,1,1,1,1,0,206,166,2731,0
fernandomitre,fernandomitre,,1,0,1,1,0,1,0,0,0,0,206,166,2730,0
Wildhoneyu21,Wildhoneyu21,,0,2,2,0,2,2,2,0.666667,0.75,0,62,0,2732,0
ForadaCurvaBR,ForadaCurvaBR,,0,1,1,0,1,1,1,1,1,0,73,0,2733,0
Ravick_BlueLion,Ravick_BlueLion,,0,2,2,0,2,2,2,0.666667,0.75,0,62,0,2734,0
TosiRoseli,TosiRoseli,,0,1,1,0,1,1,1,1,1,0,73,0,2735,0
Makkarius57,Makkarius57,,0,3,3,0,3,3,1,1,1,0,115,0,2736,0.166667
jorgeandre1980,jorgeandre1980,,0,1,1,0,1,1,1,1,1,0,19,0,2737,0
EmidRR,EmidRR,,0,1,1,0,1,1,2,0.6,0.666667,0,62,0,2738,0
ocariocajr,ocariocajr,,0,1,1,0,1,1,2,0.545455,0.583333,0,10,0,2739,0
Nathan_Batista,Nathan_Batista,,0,1,1,0,1,1,1,1,1,0,73,0,2740,0
Sou2022C,Sou2022C,,0,1,1,0,1,1,1,1,1,0,73,0,2741,0
IraldaFanni,IraldaFanni,,0,2,2,0,2,2,1,1,1,0,4,0,2742,0
JORGEHELENO4,JORGEHELENO4,,0,1,1,0,1,1,1,1,1,0,73,0,2743,0
ademirduartebar,ademirduartebar,,0,1,1,0,1,1,1,1,1,0,73,0,2744,0
JonasLaico,JonasLaico,,0,2,2,0,3,3,2,0.666667,0.75,0,62,0,2745,0
GuidoSanick,GuidoSanick,,0,3,3,0,3,3,1,1,1,0,115,0,2746,0.166667
JazzminRosa,JazzminRosa,,0,1,1,0,1,1,2,0.545455,0.583333,0,10,0,2747,0
ivanxitara10,ivanxitara10,,0,1,1,0,1,1,1,1,1,0,73,0,2748,0
Makotok71472792,Makotok71472792,,0,1,1,0,1,1,1,1,1,0,73,0,2749,0
msdias70,msdias70,,0,2,2,0,3,3,2,0.583333,0.642857,0,10,0,2750,0
julianorico1,julianorico1,,0,3,3,0,3,3,1,1,1,0,115,0,2751,0.166667
Carmen_Gua,Carmen_Gua,,0,3,3,0,3,3,1,1,1,0,115,0,2752,0.166667
cabista691,cabista691,,0,3,3,0,3,3,1,1,1,0,115,0,2753,0.166667
jes_thamela,jes_thamela,,0,3,3,0,3,3,1,1,1,0,115,0,2754,0.166667
bidoia_ricardo,bidoia_ricardo,,0,1,1,0,1,1,1,1,1,0,73,0,2755,0
MarthaCarneiro1,MarthaCarneiro1,,0,2,2,0,2,2,1,1,1,0,213,0,2756,0
claudiaranjos,claudiaranjos,,0,1,1,0,1,1,1,1,1,0,5,0,2757,0
Gigi27822870,Gigi27822870,,0,1,1,0,1,1,1,1,1,0,73,0,2758,0
Marcelladlm13,Marcelladlm13,,0,3,3,0,3,3,1,1,1,0,115,0,2759,0.166667
AureaAp,AureaAp,,0,1,1,0,1,1,1,1,1,0,73,0,2760,0
silviaphalange,silviaphalange,,0,1,1,0,1,1,1,1,1,0,19,0,2761,0
LuuhSoares1313,LuuhSoares1313,,0,3,3,0,3,3,1,1,1,0,115,0,2762,0.166667
MarciaParenteBa,MarciaParenteBa,,0,1,1,0,1,1,1,1,1,0,4,0,2763,0
cemerenciano,cemerenciano,,0,1,1,0,1,1,2,0.545455,0.583333,0,10,0,2764,0
saviosiqueira,saviosiqueira,,0,2,2,0,2,2,2,0.666667,0.75,0,62,0,2765,0
CarlaNaudererRS,CarlaNaudererRS,,0,1,1,0,1,1,1,1,1,0,19,0,2766,0
CocReality,CocReality,,0,3,3,0,3,3,1,1,1,0,115,0,2767,0.166667
tebolzani03,tebolzani03,,0,1,1,0,1,1,1,1,1,0,213,0,2768,0
JulianaMgc,JulianaMgc,,0,1,1,0,1,1,1,1,1,0,73,0,2769,0
SarahBFrade,SarahBFrade,,0,1,1,0,1,1,1,1,1,0,153,0,2770,0
FrancinaldoRafa,FrancinaldoRafa,,0,1,1,0,1,1,1,1,1,0,19,0,2771,0
PedroRo83416314,PedroRo83416314,,0,1,1,0,1,1,1,1,1,0,73,0,2772,0
AbdonGalo,AbdonGalo,,0,1,1,0,1,1,1,1,1,0,4,0,2773,0
Helioma54965324,Helioma54965324,,0,3,3,0,3,3,1,1,1,0,115,0,2774,0.166667
lauracleite,lauracleite,,0,1,1,0,1,1,2,0.545455,0.583333,0,10,0,2775,0
NinaK_13,NinaK_13,,0,1,1,0,1,1,1,1,1,0,207,167,2777,0
alecarvalho_se,alecarvalho_se,,2,0,2,2,0,2,0,0,0,0,207,167,2776,0
Edinald93535217,Edinald93535217,,0,3,3,0,3,3,1,1,1,0,115,0,2778,0.166667
Jacquefelizjf,Jacquefelizjf,,0,1,1,0,1,1,1,1,1,0,73,0,2779,0
EduVicente2,EduVicente2,,0,1,1,0,1,1,1,1,1,0,19,0,2780,0
anacaminha,anacaminha,,0,1,1,0,1,1,1,1,1,0,73,0,2781,0
tweeter_newbie,tweeter_newbie,,0,1,1,0,1,1,1,1,1,0,19,0,2782,0
MarcaoAzevedo,MarcaoAzevedo,,0,3,3,0,3,3,1,1,1,0,115,0,2783,0.166667
GusLanzetta,GusLanzetta,,0,3,3,0,3,3,1,1,1,0,115,0,2784,0.166667
JefersnPelozi,JefersnPelozi,,0,3,3,0,3,3,1,1,1,0,115,0,2785,0.166667
diasgm,diasgm,,0,3,3,0,3,3,1,1,1,0,115,0,2786,0.166667
paulamanto77,paulamanto77,,0,1,1,0,1,1,1,1,1,0,73,0,2787,0
foradoalcance,foradoalcance,,0,1,1,0,1,1,1,1,1,0,4,0,2788,0
JAM95231714,JAM95231714,,0,1,1,0,1,1,1,1,1,0,73,0,2789,0
Paulospo,Paulospo,,0,1,1,0,1,1,1,1,1,0,19,0,2790,0
LuhMegi,LuhMegi,,0,3,3,0,3,3,1,1,1,0,115,0,2791,0.166667
dioramasdoor,dioramasdoor,,0,1,1,0,1,1,1,1,1,0,19,0,2792,0
johnlino10,johnlino10,,0,1,1,0,1,1,1,1,1,0,73,0,2793,0
FLAnaticoRubro,FLAnaticoRubro,,0,1,1,0,1,1,1,1,1,0,19,0,2794,0
garneck3,garneck3,,0,1,1,0,1,1,1,1,1,0,19,0,2795,0
ManoelFrancoJr3,ManoelFrancoJr3,,0,1,1,0,1,1,1,1,1,0,19,0,2796,0
HenriqkM,HenriqkM,,0,1,1,0,1,1,1,1,1,0,19,0,2797,0
Sponer,Sponer,,0,1,1,0,1,1,1,1,1,0,73,0,2798,0
bareias86,bareias86,,0,1,1,0,1,1,1,1,1,0,19,0,2799,0
Matheus_Bad92,Matheus_Bad92,,0,1,1,0,3,3,1,1,1,0,5,0,2800,0
spxt_,spxt_,,0,1,1,0,1,1,1,1,1,0,19,0,2801,0
JoaogoulartJoao,JoaogoulartJoao,,0,1,1,0,1,1,1,1,1,0,19,0,2802,0
cxringaoz,cxringaoz,,0,1,1,0,1,1,1,1,1,0,19,0,2803,0
remembermarilia,remembermarilia,,0,1,1,0,1,1,1,1,1,0,19,0,2804,0
marciospraz,marciospraz,,0,1,1,0,1,1,1,1,1,0,19,0,2805,0
ZalbaKrohn,ZalbaKrohn,,0,1,1,0,1,1,1,1,1,0,19,0,2806,0
NayaraGalimbert,NayaraGalimbert,,0,1,1,0,1,1,1,1,1,0,73,0,2807,0
facunhasantana,facunhasantana,,0,1,1,0,1,1,1,1,1,0,19,0,2808,0
imondacouch,imondacouch,,0,1,1,0,1,1,1,1,1,0,207,167,2809,0
galloradical,galloradical,,2,2,4,2,2,4,2,0.666667,0.75,0,0,0,285,1
Ana_Ortiz_Sa,Ana_Ortiz_Sa,,0,2,2,0,2,2,2,0.666667,0.75,0,62,0,2810,0
ElielcoSoares,ElielcoSoares,,0,1,1,0,1,1,2,0.6,0.666667,0,31,0,2811,0
LFeministe,LFeministe,,0,1,1,0,1,1,1,1,1,0,0,0,2812,0
SaaSPumP,SaaSPumP,,0,1,1,0,1,1,1,1,1,0,29,0,2813,0
JonasRFaria,JonasRFaria,,0,1,1,0,1,1,1,1,1,0,73,0,2814,0
xarope_bolado,xarope_bolado,,0,1,1,0,1,1,1,1,1,0,73,0,2815,0
djs_diogo,djs_diogo,,0,2,2,0,2,2,1,1,1,0,153,0,2816,0
Roni_ms93,Roni_ms93,,0,2,2,0,2,2,1,1,1,0,73,0,2817,0
CunhaElderson,CunhaElderson,,0,1,1,0,1,1,1,1,1,0,208,168,2819,0
caemartins,caemartins,,1,0,1,1,0,1,0,0,0,0,208,168,2818,0
eltonpacheco,eltonpacheco,,0,1,1,0,1,1,1,1,1,0,209,169,2821,0
IbaneisOficial,IbaneisOficial,,1,0,1,1,0,1,0,0,0,0,209,169,2820,0
JJDelga12323133,JJDelga12323133,,0,1,1,0,3,3,1,1,1,0,29,0,2822,0
Ricardo83207448,Ricardo83207448,,0,1,1,0,1,1,1,1,1,0,210,170,2824,0
rcampossuisse,rcampossuisse,,1,0,1,1,0,1,0,0,0,0,210,170,2823,0
amarildo_valle,amarildo_valle,,0,1,1,0,1,1,2,0.545455,0.583333,0,10,0,2825,0
10_adalberto20,10_adalberto20,,0,1,1,0,1,1,1,1,1,0,73,0,2826,0
EnockUlle,EnockUlle,,0,2,2,0,2,2,2,0.666667,0.75,0,62,0,2827,0
zaninhalacerda,zaninhalacerda,,0,1,1,0,1,1,1,1,1,0,73,0,2828,0
cruz_edigar,cruz_edigar,,1,0,1,1,0,1,0,0,0,0,10,0,341,0
Rochalgabs,Rochalgabs,,0,2,2,0,2,2,2,0.666667,0.75,0,62,0,2829,0
cmendoncale,cmendoncale,,0,1,1,0,1,1,1,1,1,0,4,0,2830,0
Souza8Magda,Souza8Magda,,0,1,1,0,1,1,1,1,1,0,73,0,2831,0
catarinaprax,catarinaprax,,0,3,3,0,3,3,4,0.456897,0.490566,0,27,0,2832,0.333333
FabyR17,FabyR17,,0,1,1,0,1,1,1,1,1,0,29,0,2833,0
PoemaEspiritas,PoemaEspiritas,,0,2,2,0,2,2,2,0.666667,0.75,0,62,0,2834,0
GwgMinas,GwgMinas,,0,1,1,0,1,1,1,1,1,0,73,0,2835,0
ZorfuzZ,ZorfuzZ,,0,1,1,0,1,1,1,1,1,0,73,0,2836,0
lmoshill,lmoshill,,0,2,2,0,2,2,1,1,1,0,87,55,2837,0.5
ewertu,ewertu,,0,2,2,0,2,2,2,0.666667,0.75,0,62,0,2838,0
Marcosjose3838,Marcosjose3838,,0,1,1,0,1,1,1,1,1,0,73,0,2839,0
salifersil,salifersil,,0,2,2,0,2,2,2,0.666667,0.75,0,62,0,2840,0
Wezley1980,Wezley1980,,0,1,1,0,1,1,1,1,1,0,4,0,2841,0
SemTraquejo,SemTraquejo,,0,1,1,0,1,1,1,1,1,0,73,0,2842,0
cotequezada,cotequezada,,0,1,1,0,1,1,1,1,1,0,68,42,2843,0
GrillNandus,GrillNandus,,0,4,4,0,7,7,1,1,1,0,4,0,2844,0.166667
Avan__RJ,Avan__RJ,,0,1,1,0,1,1,1,1,1,0,211,171,2846,0
CeoDandara,CeoDandara,,1,0,1,1,0,1,0,0,0,0,211,171,2845,0
galeno1219,galeno1219,,0,1,1,0,3,3,1,1,1,0,29,0,2847,0
ricardosog,ricardosog,,0,2,2,0,2,2,2,0.666667,0.75,0,62,0,2848,0
ari_moreir,ari_moreir,,0,1,1,0,1,1,1,1,1,0,41,0,2849,0
vladswc,vladswc,,0,2,2,0,2,2,2,0.666667,0.75,0,62,0,2850,0
paulofs2002,paulofs2002,,0,1,1,0,1,1,1,1,1,0,73,0,2851,0
Marcus_Nasc,Marcus_Nasc,,0,2,2,0,2,2,2,0.666667,0.75,0,62,0,2852,0
nidingrr,nidingrr,,0,2,2,0,2,2,2,0.666667,0.75,0,62,0,2853,0
thmoya,thmoya,,0,1,1,0,1,1,2,0.545455,0.583333,0,10,0,2854,0
caiojunqueiraf,caiojunqueiraf,,0,2,2,0,2,2,1,1,1,0,76,0,2855,1
SaudeemFoco,SaudeemFoco,,21,0,21,21,0,21,0,0,0,0,19,0,2,0
YouGov,YouGov,,21,0,21,21,0,21,0,0,0,0,19,0,1,0
francisco591106,francisco591106,,0,1,1,0,1,1,1,1,1,0,29,0,2856,0
MAYELAHJ,MAYELAHJ,,0,1,1,0,1,1,1,1,1,0,29,0,2857,0
dearhgc,dearhgc,,0,2,2,0,2,2,1,1,1,0,19,0,2858,0
Tobias_VacinaJa,Tobias_VacinaJa,,0,1,1,0,1,1,2,0.545455,0.583333,0,10,0,2859,0
RobertDetoni,RobertDetoni,,0,1,1,0,1,1,1,1,1,0,4,0,2860,0
cberilramos,cberilramos,,0,1,1,0,1,1,1,1,1,0,25,0,2861,0
genidozepelim,genidozepelim,,0,1,1,0,1,1,1,1,1,0,10,0,2862,0
BorgesRona,BorgesRona,,0,2,2,0,2,2,1,1,1,0,76,0,2863,1
Tatygs24,Tatygs24,,0,1,1,0,1,1,1,1,1,0,25,0,2864,0
princesadamare,princesadamare,,0,2,2,0,2,2,1,1,1,0,212,172,2867,0.5
anisio2,anisio2,,1,1,2,1,1,2,1,1,1,0,212,172,2866,0.5
FrenteMare,FrenteMare,,2,0,2,2,0,2,0,0,0,0,212,172,2865,0.5
Cuetz3,Cuetz3,,0,1,1,0,1,1,1,1,1,0,29,0,2868,0
SimoneMariadeO5,SimoneMariadeO5,,0,2,2,0,2,2,1,1,1,0,76,0,2869,1
Cinthya93282894,Cinthya93282894,,0,1,1,0,1,1,1,1,1,0,29,0,2870,0
PabPuerto,PabPuerto,,0,1,1,0,1,1,1,1,1,0,29,0,2871,0
hi_cibele,hi_cibele,,0,3,3,0,3,3,2,0.615385,0.6875,0,76,0,2872,0.333333
gregoriomirabal,gregoriomirabal,,0,1,1,0,1,1,1,1,1,0,41,0,2873,0
CoiabAmazonia,CoiabAmazonia,,4,0,4,4,0,4,0,0,0,0,41,0,738,0
RGTowers,RGTowers,,0,1,1,0,1,1,1,1,1,0,29,0,2874,0
Marcia90373488,Marcia90373488,,0,1,1,0,1,1,1,1,1,0,10,0,2875,0
mcleiter,mcleiter,,0,2,2,0,2,2,1,1,1,0,76,0,2876,1
corpo_delama,corpo_delama,,0,1,1,0,1,1,2,0.545455,0.583333,0,10,0,2877,0
anti_bozopt,anti_bozopt,,0,1,1,0,1,1,2,0.545455,0.583333,0,10,0,2878,0
bibliotecaippur,bibliotecaippur,,0,2,2,0,2,2,2,0.583333,0.642857,0,76,0,2879,0
rodolfomera3,rodolfomera3,,3,0,3,3,0,3,0,0,0,0,45,0,23,0.5
luisnassif,luisnassif,,3,0,3,3,0,3,0,0,0,0,45,0,22,0.5
UNjobs_Events,UNjobs_Events,,0,2,2,0,2,2,1,1,1,0,19,0,2881,0
cidacs_fiocruz,cidacs_fiocruz,,3,0,3,3,0,3,0,0,0,0,19,0,2880,0
Abell417,Abell417,,0,4,4,0,5,5,4,0.46087,0.5,0,27,0,2882,0.25
ferreirinharj,ferreirinharj,,3,0,3,4,0,4,0,0,0,0,27,0,83,0.333333
franklinmuniz,franklinmuniz,,0,1,1,0,1,1,2,0.545455,0.583333,0,10,0,2883,0
WMT3n,WMT3n,,0,2,2,0,2,2,1,1,1,0,76,0,2884,1
MagooMito,MagooMito,,0,2,2,0,2,2,1,1,1,0,25,0,2886,0
RevistaEsmeril,RevistaEsmeril,,2,0,2,2,0,2,0,0,0,0,25,0,2885,0
ricardowelbert,ricardowelbert,,0,1,1,0,1,1,3,0.5,0.541667,0,76,0,2887,0
gersonsalvador,gersonsalvador,,112,0,112,112,0,112,0,0,0,0,213,0,65,0.00008
vano_lima,vano_lima,,0,2,2,0,2,2,1,1,1,0,76,0,2888,1
Aluizioumberto,Aluizioumberto,,0,1,1,0,1,1,2,0.6,0.666667,0,62,0,2889,0
JorgeBettiol,JorgeBettiol,,0,2,2,0,2,2,1,1,1,0,76,0,2890,1
JnatasCezar1,JnatasCezar1,,0,1,1,0,1,1,1,1,1,0,25,0,2891,0
rivaildorc,rivaildorc,,0,1,1,0,1,1,1,1,1,0,25,0,2892,0
bfgbota,bfgbota,,0,1,1,0,1,1,3,0.4,0.458333,0,0,0,2893,0
AndreMoreiraES,AndreMoreiraES,,0,1,1,0,2,2,2,0.545455,0.583333,0,10,0,2894,0
pmli1955,pmli1955,,0,1,1,0,1,1,2,0.666667,0.75,0,214,173,2897,0
financeandKM,financeandKM,,1,1,2,1,1,2,1,1,1,0,214,173,2896,0
Tiago_TioDECA,Tiago_TioDECA,,0,2,2,0,2,2,1,1,1,0,76,0,2898,1
andre_gavlak,andre_gavlak,,0,2,2,0,2,2,1,1,1,0,76,0,2899,1
JeanLec27177717,JeanLec27177717,,0,1,1,0,1,1,1,1,1,0,25,0,2900,0
ajulisbr,ajulisbr,,0,1,1,0,1,1,1,1,1,0,25,0,2901,0
GleisonFlavio21,GleisonFlavio21,,0,1,1,0,4,4,2,0.6,0.666667,0,62,0,2902,0
SimoneCAL14,SimoneCAL14,,0,2,2,0,2,2,1,1,1,0,76,0,2903,1
MarcinhaGarcao,MarcinhaGarcao,,0,1,1,0,1,1,1,1,1,0,213,0,2904,0
rodrigocoite1,rodrigocoite1,,0,1,1,0,1,1,2,0.6,0.666667,0,62,0,2905,0
madeliam1,madeliam1,,0,1,1,0,1,1,2,0.6,0.666667,0,62,0,2906,0
VANDERLEIEEDNA,VANDERLEIEEDNA,,0,1,1,0,1,1,1,1,1,0,25,0,2907,0
Malelo2711,Malelo2711,,0,2,2,0,2,2,2,0.583333,0.642857,0,213,0,2908,0
hollaquien,hollaquien,,0,2,2,0,2,2,1,1,1,0,76,0,2909,1
_marialuisa,_marialuisa,,0,1,1,0,1,1,1,1,1,0,0,0,2910,0
icon_ic,icon_ic,,0,1,1,0,1,1,1,1,1,0,215,174,2912,0
alentejo_1970,alentejo_1970,,1,0,1,1,0,1,0,0,0,0,215,174,2911,0
FerreiraCardin,FerreiraCardin,,0,1,1,0,1,1,1,1,1,0,25,0,2913,0
LuGamoradecor,LuGamoradecor,,0,1,1,0,1,1,1,1,1,0,25,0,2914,0
FerSindicalista,FerSindicalista,,0,1,1,0,1,1,1,1,1,0,88,0,2915,0
alexandredsc,alexandredsc,,0,1,1,0,1,1,1,1,1,0,0,0,2916,0
77Ammarello,77Ammarello,,0,2,2,0,2,2,1,1,1,0,4,0,2917,0.5
Lya_mferraz,Lya_mferraz,,0,1,1,0,1,1,1,1,1,0,213,0,2918,0
Jairnevesa,Jairnevesa,,0,1,1,0,1,1,1,1,1,0,216,175,2920,0
RadioAlvorada,RadioAlvorada,,1,0,1,1,0,1,0,0,0,0,216,175,2919,0
camabap,camabap,,0,2,2,0,2,2,1,1,1,0,10,0,2922,0
Madi70634980,Madi70634980,,1,0,1,1,0,1,0,0,0,0,10,0,2921,0
bdfreitas,bdfreitas,,0,1,1,0,1,1,1,1,1,0,88,0,2923,0
MagdaJEML,MagdaJEML,,0,1,1,0,1,1,1,1,1,0,25,0,2924,0
cut_minas,cut_minas,,0,1,1,0,1,1,1,1,1,0,88,0,2925,0
keepfodase,keepfodase,,0,1,1,0,1,1,2,0.571429,0.625,0,5,0,2926,0
MariaMariatnpt,MariaMariatnpt,,0,2,2,0,7,7,2,0.583333,0.642857,0,10,0,2927,0
IDCOBot,IDCOBot,,0,1,1,0,1,1,1,1,1,0,80,0,2928,0
itmalia46090314,itmalia46090314,,0,1,1,0,1,1,1,1,1,0,76,0,2929,0
VoliaAlmeida,VoliaAlmeida,,0,1,1,0,1,1,1,1,1,0,25,0,2930,0
carmennnunes,carmennnunes,,0,2,2,0,2,2,1,1,1,0,76,0,2931,1
AzulIndignado_,AzulIndignado_,,0,2,2,0,2,2,1,1,1,0,76,0,2932,1
GAM3BO1CHAN,GAM3BO1CHAN,,0,2,2,0,2,2,1,1,1,0,76,0,2933,1
cleitonsubmente,cleitonsubmente,,0,1,1,0,1,1,1,1,1,0,25,0,2934,0
peptuz,peptuz,,0,1,1,0,1,1,1,1,1,0,102,0,2935,0
renatonegrao,renatonegrao,,1,0,1,1,0,1,0,0,0,0,10,0,340,0
lucianofalbo,lucianofalbo,,0,2,2,0,2,2,1,1,1,0,76,0,2936,1
Elenibrisa,Elenibrisa,,0,1,1,0,1,1,1,1,1,0,102,0,2937,0
MarcioATC,MarcioATC,,0,3,3,0,3,3,1,1,1,0,0,0,2938,0.333333
AniLoraCNMP,AniLoraCNMP,,0,1,1,0,1,1,1,1,1,0,102,0,2939,0
_Camus_0,_Camus_0,,0,2,2,0,2,2,1,1,1,0,76,0,2940,1
leninhamoura28,leninhamoura28,,1,0,1,1,0,1,0,0,0,0,57,0,401,0
VlademirLouren2,VlademirLouren2,,0,1,1,0,1,1,1,1,1,0,88,0,2941,0
lucibianchi,lucibianchi,,0,1,1,0,1,1,1,1,1,0,25,0,2942,0
gsilvajpan,gsilvajpan,,2,0,2,3,0,3,0,0,0,0,90,57,1341,0.5
Jannuzzi18bfr,Jannuzzi18bfr,,0,2,2,0,2,2,1,1,1,0,76,0,2943,1
FernandoCesar77,FernandoCesar77,,0,2,2,0,2,2,1,1,1,0,76,0,2944,1
sirlantj,sirlantj,,0,2,2,0,2,2,1,1,1,0,76,0,2945,1
RevistaMedico,RevistaMedico,,0,1,1,0,1,1,1,1,1,0,45,0,2946,0
VanderleiComino,VanderleiComino,,0,1,1,0,1,1,1,1,1,0,4,0,2947,0
MarciaF77735886,MarciaF77735886,,0,2,2,0,2,2,2,0.583333,0.642857,0,213,0,2948,0
crdesigne,crdesigne,,0,2,2,0,2,2,1,1,1,0,76,0,2949,1
fabmascarenhas,fabmascarenhas,,0,2,2,0,2,2,1,1,1,0,76,0,2950,1
eleizomar,eleizomar,,0,2,2,0,2,2,1,1,1,0,76,0,2951,1
carvalhogilbert,carvalhogilbert,,0,2,2,0,2,2,1,1,1,0,76,0,2952,1
YuriGross5,YuriGross5,,0,2,2,0,2,2,5,0.352941,0.447222,0,4,0,2953,0.5
angoneto,angoneto,,0,1,1,0,1,1,1,1,1,0,25,0,2954,0
DilzaHeredia,DilzaHeredia,,0,1,1,0,1,1,1,1,1,0,25,0,2955,0
yec_terrza,yec_terrza,,0,1,1,0,2,2,1,1,1,0,25,0,2956,0
CristinaIeda,CristinaIeda,,0,1,1,0,1,1,1,1,1,0,25,0,2957,0
citypaperbogota,citypaperbogota,,1,2,3,1,3,4,1,1,1,0,217,176,2959,0.5
the,the,,1,0,1,2,0,2,0,0,0,0,217,176,2958,0
jonatajp,jonatajp,,0,2,2,0,2,2,1,1,1,0,76,0,2960,1
_luzgui,_luzgui,,0,2,2,0,2,2,1,1,1,0,76,0,2961,1
bardelao,bardelao,,0,1,1,0,1,1,1,1,1,0,25,0,2962,0
tvtecjundiai,tvtecjundiai,,1,0,1,2,0,2,0,0,0,0,0,0,127,0
ColellaRicardo,ColellaRicardo,,0,2,2,0,2,2,1,1,1,0,4,0,2963,0
olizinharj,olizinharj,,0,2,2,0,2,2,1,1,1,0,27,0,2964,0
pancueca,pancueca,,0,2,2,0,2,2,1,1,1,0,76,0,2965,1
aldunate_r,aldunate_r,,0,1,1,0,1,1,1,1,1,0,213,0,2966,0
Nortelaw9,Nortelaw9,,0,1,1,0,1,1,1,1,1,0,25,0,2967,0
victoranicio,victoranicio,,0,1,1,0,1,1,1,1,1,0,102,0,2968,0
CarlaCruz2302,CarlaCruz2302,,0,2,2,0,2,2,1,1,1,0,218,177,2971,0.5
ABCgovBr,ABCgovBr,,1,1,2,1,1,2,1,1,1,0,218,177,2970,0.5
Eletrobras,Eletrobras,,2,0,2,2,0,2,0,0,0,0,218,177,2969,0.5
WeltonCAlves,WeltonCAlves,,0,2,2,0,2,2,1,1,1,0,76,0,2972,1
Orobertopereira,Orobertopereira,,0,1,1,0,2,2,2,0.6,0.666667,0,62,0,2973,0
mundiicosta,mundiicosta,,0,3,3,0,3,3,1,1,1,0,219,114,2976,0.333333
ForbesBR,ForbesBR,,2,2,4,2,2,4,1,1,1,0,219,114,2975,0.333333
Microsoft,Microsoft,,3,0,3,3,0,3,0,0,0,0,219,114,2974,0.333333
thehoneybadgerD,thehoneybadgerD,,0,1,1,0,1,1,1,1,1,0,25,0,2977,0
AcademiaAny,AcademiaAny,,0,1,1,0,1,1,1,1,1,0,0,0,2978,0
3b3_3b,3b3_3b,,0,2,2,0,2,2,1,1,1,0,76,0,2979,1
roberta_robbie_,roberta_robbie_,,0,2,2,0,2,2,1,1,1,0,76,0,2980,1
LeonardoGama25,LeonardoGama25,,0,2,2,0,2,2,1,1,1,0,76,0,2981,1
ale_giseli,ale_giseli,,2,2,4,2,2,4,2,0.75,0.833333,0,5,0,339,0.25
maatdaher,maatdaher,,0,2,2,0,2,2,1,1,1,0,76,0,2982,1
neocimeire,neocimeire,,0,1,1,0,1,1,1,1,1,0,25,0,2983,0
ryaneakane,ryaneakane,,0,2,2,0,2,2,1,1,1,0,76,0,2984,1
americacapitao7,americacapitao7,,0,1,1,0,1,1,1,1,1,0,25,0,2985,0
Miranda110282,Miranda110282,,0,1,1,0,1,1,1,1,1,0,25,0,2986,0
markinmedeiros,markinmedeiros,,0,2,2,0,2,2,1,1,1,0,76,0,2987,1
Tabyta201,Tabyta201,,0,1,1,0,1,1,1,1,1,0,0,0,2988,0
notnille,notnille,,0,2,2,0,2,2,1,1,1,0,76,0,2989,1
eumesmavivi0,eumesmavivi0,,0,1,1,0,1,1,1,1,1,0,25,0,2990,0
LigiaGuerra7,LigiaGuerra7,,0,1,1,0,1,1,1,1,1,0,25,0,2991,0
Lujakson,Lujakson,,0,2,2,0,2,2,1,1,1,0,76,0,2992,1
indioxinguvivo,indioxinguvivo,,0,1,1,0,1,1,1,1,1,0,41,0,2993,0
ammarello77,ammarello77,,0,1,1,0,1,1,1,1,1,0,25,0,2994,0
EFeij,EFeij,,0,1,1,0,1,1,1,1,1,0,76,0,2995,0
JohnMstk,JohnMstk,,0,1,1,0,1,1,1,1,1,0,25,0,2996,0
MariaMagan1,MariaMagan1,,0,1,1,0,1,1,1,1,1,0,25,0,2997,0
Nakayuki_OldAge,Nakayuki_OldAge,,0,2,2,0,2,2,1,1,1,0,76,0,2998,1
hussfo_,hussfo_,,0,2,2,0,2,2,1,1,1,0,76,0,2999,1
portalservidor,portalservidor,,0,1,1,0,1,1,1,1,1,0,220,178,3001,0
governodabahia,governodabahia,,2,0,2,2,0,2,0,0,0,0,220,178,3000,0
liviario,liviario,,0,2,2,0,2,2,1,1,1,0,76,0,3002,1
lucimargianott3,lucimargianott3,,0,1,1,0,1,1,1,1,1,0,5,0,3003,0
GustavoOrnelasS,GustavoOrnelasS,,0,2,2,0,2,2,1,1,1,0,76,0,3004,1
Palmeiras,Palmeiras,,4,0,4,4,0,4,0,0,0,0,5,0,131,0.25
VOAPortugues,VOAPortugues,,1,0,1,1,0,1,0,0,0,0,8,0,658,0
michelAAnews,michelAAnews,,0,1,1,0,1,1,1,1,1,0,25,0,3005,0
carlosrafer,carlosrafer,,0,2,2,0,2,2,1,1,1,0,76,0,3006,1
NesiaLasinha,NesiaLasinha,,0,1,1,0,1,1,1,1,1,0,213,0,3007,0
luksgf,luksgf,,0,2,2,0,2,2,1,1,1,0,76,0,3008,1
marciafmm,marciafmm,,0,2,2,0,2,2,1,1,1,0,76,0,3009,1
MiticaEscorpia,MiticaEscorpia,,0,1,1,0,1,1,2,0.545455,0.583333,0,10,0,3010,0
Ademirl87226461,Ademirl87226461,,0,2,2,0,5,5,2,0.666667,0.75,0,5,0,3011,0.5
RafaelGilardino,RafaelGilardino,,0,2,2,0,2,2,1,1,1,0,76,0,3012,1
claus_2019,claus_2019,,0,1,1,0,1,1,1,1,1,0,4,0,3013,0
Zanon2910,Zanon2910,,0,1,1,0,3,3,2,0.545455,0.583333,0,10,0,3014,0
PimMaiden,PimMaiden,,0,1,1,0,1,1,1,1,1,0,25,0,3015,0
opropriophill,opropriophill,,0,1,1,0,1,1,1,1,1,0,25,0,3016,0
EstelaB73310044,EstelaB73310044,,0,1,1,0,1,1,1,1,1,0,25,0,3017,0
VeroInstituto,VeroInstituto,,0,1,1,0,1,1,1,1,1,0,102,0,3018,0
boni_lima10,boni_lima10,,0,1,1,0,1,1,1,1,1,0,4,0,3019,0
Observoaqueda,Observoaqueda,,0,1,1,0,1,1,2,0.545455,0.583333,0,10,0,3020,0
LookingCritical,LookingCritical,,0,3,3,0,3,3,2,0.8,0.875,0,5,0,3021,0.333333
kkkgimenez,kkkgimenez,,0,1,1,0,1,1,2,0.571429,0.625,0,5,0,3022,0
filomenaadan,filomenaadan,,0,1,1,0,1,1,1,1,1,0,25,0,3023,0
DaniJuicebox,DaniJuicebox,,0,1,1,0,1,1,2,0.545455,0.583333,0,10,0,3024,0
LeniltonMendes,LeniltonMendes,,0,2,2,0,2,2,1,1,1,0,4,0,3025,0
alexruts,alexruts,,0,1,1,0,1,1,1,1,1,0,221,179,3027,0
EnelClientesBR,EnelClientesBR,,1,0,1,1,0,1,0,0,0,0,221,179,3026,0
martinswil,martinswil,,0,1,1,0,1,1,1,1,1,0,25,0,3028,0
facguska,facguska,,0,1,1,0,1,1,1,1,1,0,4,0,3029,0
Mcfcoach,Mcfcoach,,0,1,1,0,1,1,1,1,1,0,25,0,3030,0
viovica2000,viovica2000,,0,1,1,0,2,2,1,1,1,0,0,0,3031,0
MargotMHorowicz,MargotMHorowicz,,0,2,2,0,2,2,1,1,1,0,45,0,3032,0.5
FelipeVeigaTen,FelipeVeigaTen,,0,1,1,0,1,1,1,1,1,0,4,0,3033,0
thais_comteaga,thais_comteaga,,0,1,1,0,1,1,1,1,1,0,213,0,3034,0
vitorsarno,vitorsarno,,0,1,1,0,1,1,1,1,1,0,5,0,3035,0
Solutio66869775,Solutio66869775,,0,1,1,0,1,1,1,1,1,0,4,0,3036,0
lcrudo,lcrudo,,0,1,1,0,1,1,1,1,1,0,62,0,3037,0
MarcoguchiMarco,MarcoguchiMarco,,0,1,1,0,1,1,1,1,1,0,4,0,3038,0
raquelita77bo,raquelita77bo,,0,2,2,0,2,2,2,0.583333,0.642857,0,4,0,3039,0
rafael_milanesi,rafael_milanesi,,0,1,1,0,1,1,1,1,1,0,4,0,3040,0
carlinibh,carlinibh,,0,1,1,0,1,1,1,1,1,0,4,0,3041,0
tthaizera,tthaizera,,0,1,1,0,1,1,1,1,1,0,4,0,3042,0
larrybroche,larrybroche,,0,1,1,0,1,1,1,1,1,0,4,0,3043,0
FEEICOMPETE2020,FEEICOMPETE2020,,0,1,1,0,1,1,1,1,1,0,31,0,3044,0
blush0101,blush0101,,0,1,1,0,1,1,1,1,1,0,10,0,3045,0
freireec,freireec,,0,1,1,0,1,1,1,1,1,0,213,0,3046,0
AcademiaMedica,AcademiaMedica,,1,0,1,2,0,2,0,0,0,0,0,0,126,0
NachoDomingue,NachoDomingue,,0,1,1,0,1,1,1,1,1,0,25,0,3047,0
Rosi_2808,Rosi_2808,,0,1,1,0,1,1,1,1,1,0,25,0,3048,0
HeraldoMoreira,HeraldoMoreira,,0,1,1,0,1,1,1,1,1,0,213,0,3049,0
mbnetto2,mbnetto2,,0,2,2,0,2,2,1,1,1,0,19,0,3050,0
JuhFBatist,JuhFBatist,,0,1,1,0,1,1,1,1,1,0,222,180,3052,0
AGazetaES,AGazetaES,,1,0,1,1,0,1,0,0,0,0,222,180,3051,0
uolconfere,uolconfere,,0,1,1,0,1,1,1,1,1,0,102,0,3053,0
AlexandreBonora,AlexandreBonora,,0,1,1,0,1,1,1,1,1,0,25,0,3054,0
jaezerdantas,jaezerdantas,,0,1,1,0,1,1,1,1,1,0,76,0,3055,0
RoseCereja10,RoseCereja10,,0,1,1,0,1,1,1,1,1,0,25,0,3056,0
canalriasbaixas,canalriasbaixas,,1,0,1,1,0,1,0,0,0,0,0,0,125,0
AnaReginaAlves9,AnaReginaAlves9,,0,1,1,0,1,1,1,1,1,0,25,0,3057,0
MarcioMattosSP,MarcioMattosSP,,0,1,1,0,1,1,1,1,1,0,25,0,3058,0
duartesrf,duartesrf,,0,1,1,0,1,1,1,1,1,0,213,0,3059,0
BorgesBrasil50,BorgesBrasil50,,0,1,1,0,1,1,1,1,1,0,25,0,3060,0
tatto352004,tatto352004,,0,1,1,0,1,1,2,0.545455,0.583333,0,10,0,3061,0
andersonglrt,andersonglrt,,0,1,1,0,1,1,1,1,1,0,0,0,3062,0
VulpesMG,VulpesMG,,0,1,1,0,1,1,1,1,1,0,25,0,3063,0
Joberto14,Joberto14,,0,1,1,0,1,1,1,1,1,0,25,0,3064,0
JosePB1984,JosePB1984,,0,1,1,0,1,1,1,1,1,0,25,0,3065,0
antoniojoserj,antoniojoserj,,0,1,1,0,2,2,1,1,1,0,25,0,3066,0
SA_PhD,SA_PhD,,2,3,5,2,9,11,1,1,1,0,288,181,3068,0.333333
outbreak_india,outbreak_india,,3,2,5,6,2,8,2,0.6,0.666667,0,288,181,3068,0.833333
KP01011,KP01011,,2,4,6,4,4,8,1,1,1,0,288,181,3068,0.583333
MonicaGrayley,MonicaGrayley,,0,3,3,0,4,4,1,1,1,0,31,0,3069,0.333333
MoetiTshidi,MoetiTshidi,,4,0,4,4,0,4,0,0,0,0,31,0,119,0.25
Joice21909666,Joice21909666,,0,1,1,0,1,1,1,1,1,0,80,0,3070,0
JooRodr91678856,JooRodr91678856,,0,1,1,0,1,1,1,1,1,0,8,0,3071,0
RobindosBosque2,RobindosBosque2,,0,1,1,0,3,3,1,1,1,0,8,0,3072,0
mpresidencia_pt,mpresidencia_pt,,0,1,1,0,1,1,2,0.6,0.666667,0,8,0,3073,0
LMadanelo,LMadanelo,,0,1,1,0,1,1,1,1,1,0,213,0,3074,0
GideonRochartas,GideonRochartas,,0,1,1,0,1,1,1,1,1,0,213,0,3075,0
tixapearce,tixapearce,,0,2,2,0,2,2,1,1,1,0,0,0,3076,0.5
psbnacamara,psbnacamara,,3,1,4,4,1,5,1,1,1,0,0,0,123,0.25
BiradoPindare,BiradoPindare,,4,0,4,5,0,5,0,0,0,0,0,0,122,0.25
sempreumpapo,sempreumpapo,,1,0,1,1,0,1,0,0,0,0,115,0,4,0
alejanvalverde,alejanvalverde,,1,0,1,1,0,1,0,0,0,0,286,91,1806,0
Thayann74204932,Thayann74204932,,0,1,1,0,1,1,1,1,1,0,25,0,3077,0
mario_uro,mario_uro,,0,1,1,0,1,1,1,1,1,0,223,182,3079,0
OsmarTerra,OsmarTerra,,1,0,1,1,0,1,0,0,0,0,223,182,3078,0
armandoradio,armandoradio,,0,1,1,0,1,1,1,1,1,0,224,183,3081,0
mundo_china,mundo_china,,1,0,1,1,0,1,0,0,0,0,224,183,3080,0
medicinaufmg,medicinaufmg,,0,1,1,0,1,1,1,1,1,0,225,184,3083,0
saudecomciencia,saudecomciencia,,2,0,2,2,0,2,0,0,0,0,225,184,3082,0
CaioAPrado,CaioAPrado,,0,2,2,0,2,2,1,1,1,0,45,0,3084,0
saraalvesdagrac,saraalvesdagrac,,0,1,1,0,1,1,1,1,1,0,41,0,3085,0
MDSouza16,MDSouza16,,0,1,1,0,1,1,1,1,1,0,25,0,3086,0
JessyTolkien,JessyTolkien,,0,1,1,0,1,1,1,1,1,0,25,0,3087,0
ValterdeSantan7,ValterdeSantan7,,0,1,1,0,1,1,1,1,1,0,25,0,3088,0
airton_fernand,airton_fernand,,0,1,1,0,1,1,1,1,1,0,25,0,3089,0
GercinoGer,GercinoGer,,0,1,1,0,5,5,2,0.6,0.666667,0,62,0,3090,0
TERESAJESUSDEO1,TERESAJESUSDEO1,,0,1,1,0,1,1,1,1,1,0,25,0,3091,0
renatarecreio,renatarecreio,,0,1,1,0,1,1,1,1,1,0,62,0,3092,0
LUDMILOV,LUDMILOV,,0,1,1,0,1,1,1,1,1,0,25,0,3093,0
cinthia_ruol,cinthia_ruol,,0,1,1,0,1,1,1,1,1,0,213,0,3094,0
sagraca1,sagraca1,,0,1,1,0,1,1,1,1,1,0,62,0,3095,0
Criscsilvaa,Criscsilvaa,,0,1,1,0,1,1,2,0.6,0.666667,0,8,0,3096,0
leticiamnl,leticiamnl,,0,1,1,0,1,1,2,0.545455,0.583333,0,10,0,3097,0
VGNoticias,VGNoticias,,1,3,4,2,3,5,2,0.8,0.875,0,0,0,118,0.166667
assembleiamt,assembleiamt,,2,0,2,2,0,2,0,0,0,0,0,0,117,0.5
adrianslima_adv,adrianslima_adv,,0,1,1,0,1,1,1,1,1,0,25,0,3098,0
EsterlaineAvila,EsterlaineAvila,,0,1,1,0,1,1,1,1,1,0,25,0,3099,0
jt_rebelo,jt_rebelo,,0,1,1,0,2,2,1,1,1,0,8,0,3100,0
Alecrimdesigner,Alecrimdesigner,,0,1,1,0,1,1,1,1,1,0,25,0,3101,0
eflos,eflos,,0,1,1,0,1,1,1,1,1,0,213,0,3102,0
BrunoEnglerDM,BrunoEnglerDM,,1,0,1,1,0,1,0,0,0,0,76,0,214,0
DeputadoBarto,DeputadoBarto,,1,0,1,1,0,1,0,0,0,0,76,0,213,0
Josegarcian,Josegarcian,,0,2,2,0,2,2,1,1,1,0,80,0,3103,0
augus7rn,augus7rn,,0,1,1,0,1,1,1,1,1,0,213,0,3104,0
SilMarq,SilMarq,,0,1,1,0,1,1,1,1,1,0,213,0,3105,0
_evso,_evso,,0,1,1,0,1,1,1,1,1,0,213,0,3106,0
amulhercanhota,amulhercanhota,,0,1,1,0,1,1,2,0.6,0.666667,0,8,0,3107,0
educacaobahia,educacaobahia,,0,1,1,0,1,1,1,1,1,0,220,178,3108,0
guilhermemafra1,guilhermemafra1,,0,1,1,0,1,1,1,1,1,0,213,0,3109,0
RMSA19747868,RMSA19747868,,0,1,1,0,1,1,1,1,1,0,25,0,3110,0
DrTedros,DrTedros,,3,0,3,3,0,3,0,0,0,0,5,0,338,0.333333
SupositorioMent,SupositorioMent,,0,3,3,0,3,3,1,1,1,0,4,0,3111,0.166667
HermPantaleao,HermPantaleao,,0,1,1,0,1,1,1,1,1,0,213,0,3112,0
PedroDeMenezes3,PedroDeMenezes3,,0,1,1,0,1,1,1,1,1,0,25,0,3113,0
CaldasHeleno,CaldasHeleno,,0,1,1,0,1,1,1,1,1,0,19,0,3114,0
EnasRocha1,EnasRocha1,,0,1,1,0,1,1,1,1,1,0,25,0,3115,0
MRao1802,MRao1802,,0,1,1,0,1,1,1,1,1,0,0,0,3116,0
POLEMMICODVJ,POLEMMICODVJ,,0,1,1,0,1,1,1,1,1,0,25,0,3117,0
EAMNewlink,EAMNewlink,,0,1,1,0,1,1,1,1,1,0,29,0,3118,0
Virology_FAMERP,Virology_FAMERP,,4,2,6,4,2,6,2,0.666667,0.75,0,76,0,638,0.5
sandraschulzcar,sandraschulzcar,,0,1,1,0,1,1,1,1,1,0,25,0,3119,0
CarmoBarbosa9,CarmoBarbosa9,,0,1,1,0,1,1,1,1,1,0,25,0,3120,0
F4810_0,F4810_0,,0,1,1,0,1,1,1,1,1,0,25,0,3121,0
schifter71,schifter71,,1,1,2,1,1,2,0,0,0,0,226,185,3122,0
emiliomoreno,emiliomoreno,,0,1,1,0,1,1,1,1,1,0,102,0,3123,0
lenyopc,lenyopc,,0,1,1,0,1,1,1,1,1,0,25,0,3124,0
MarlySLuz1,MarlySLuz1,,0,1,1,0,1,1,1,1,1,0,25,0,3125,0
paulaceolin,paulaceolin,,0,1,1,0,1,1,1,1,1,0,25,0,3126,0
ClaudioLuz_,ClaudioLuz_,,0,1,1,0,1,1,1,1,1,0,25,0,3127,0
PatriotaPaulis2,PatriotaPaulis2,,0,1,1,0,1,1,1,1,1,0,25,0,3128,0
Lilian14876478,Lilian14876478,,0,1,1,0,1,1,1,1,1,0,25,0,3129,0
varjao_erick,varjao_erick,,0,1,1,0,1,1,1,1,1,0,25,0,3130,0
dfdguimaraes,dfdguimaraes,,0,1,1,0,1,1,1,1,1,0,25,0,3131,0
Capriollirx,Capriollirx,,0,1,1,0,1,1,1,1,1,0,25,0,3132,0
FabioORibeiro,FabioORibeiro,,0,1,1,0,1,1,1,1,1,0,213,0,3133,0
JoaoRLSoares1,JoaoRLSoares1,,0,1,1,0,1,1,1,1,1,0,25,0,3134,0
BernardoVaz14,BernardoVaz14,,0,1,1,0,1,1,1,1,1,0,25,0,3135,0
marcii1972,marcii1972,,0,1,1,0,1,1,1,1,1,0,25,0,3136,0
ElisaNunesSL,ElisaNunesSL,,1,0,1,1,0,1,0,0,0,0,147,0,745,0
suzetesouza5,suzetesouza5,,0,1,1,0,1,1,1,1,1,0,25,0,3137,0
hercules_nesher,hercules_nesher,,0,1,1,0,1,1,1,1,1,0,25,0,3138,0
KarlaKarioca,KarlaKarioca,,0,1,1,0,1,1,1,1,1,0,25,0,3139,0
AhmedCassio,AhmedCassio,,0,1,1,0,1,1,1,1,1,0,25,0,3140,0
leo1554,leo1554,,0,1,1,0,1,1,1,1,1,0,25,0,3141,0
USAemPortugues,USAemPortugues,,0,2,2,0,3,3,1,1,1,0,227,186,3144,0
PowerUSAID,PowerUSAID,,1,0,1,2,0,2,0,0,0,0,227,186,3143,0
USAID,USAID,,1,0,1,1,0,1,0,0,0,0,227,186,3142,0
Mabianchi0627,Mabianchi0627,,0,1,1,0,1,1,1,1,1,0,25,0,3145,0
sangriaman,sangriaman,,1,0,1,1,0,1,0,0,0,0,92,59,1376,0
92minut0,92minut0,,1,0,1,1,0,1,0,0,0,0,92,59,1375,0
Carlosrj20001,Carlosrj20001,,0,1,1,0,1,1,1,1,1,0,25,0,3146,0
ahkbar2,ahkbar2,,0,1,1,0,1,1,1,1,1,0,102,0,3147,0
BiaCerqueira_,BiaCerqueira_,,1,0,1,2,0,2,0,0,0,0,76,0,211,0
msoares,msoares,,0,1,1,0,1,1,1,1,1,0,102,0,3148,0
csnunes1,csnunes1,,0,1,1,0,1,1,1,1,1,0,25,0,3149,0
WFKLS,WFKLS,,0,1,1,0,1,1,1,1,1,0,25,0,3150,0
leandrinocm,leandrinocm,,0,1,1,0,1,1,1,1,1,0,213,0,3151,0
rvcastrovix,rvcastrovix,,0,1,1,0,1,1,1,1,1,0,25,0,3152,0
Carla44886931,Carla44886931,,0,1,1,0,1,1,1,1,1,0,25,0,3153,0
idalina_zanetti,idalina_zanetti,,0,1,1,0,1,1,1,1,1,0,25,0,3154,0
RosineideSena,RosineideSena,,0,1,1,0,1,1,1,1,1,0,213,0,3155,0
biellkl,biellkl,,0,1,1,0,1,1,2,0.545455,0.583333,0,10,0,3156,0
FAssisSantos,FAssisSantos,,0,1,1,0,1,1,1,1,1,0,74,0,3157,0
WuYH802,WuYH802,,0,1,1,0,1,1,1,1,1,0,228,187,3159,0
taiwan_no_br,taiwan_no_br,,1,0,1,1,0,1,0,0,0,0,228,187,3158,0
DeLuCa,DeLuCa,,0,1,1,0,1,1,1,1,1,0,102,0,3160,0
FranzWines,FranzWines,,0,1,1,0,1,1,1,1,1,0,25,0,3161,0
EdisonPotiguar,EdisonPotiguar,,0,1,1,0,1,1,1,1,1,0,25,0,3162,0
NinaFerrari2,NinaFerrari2,,0,1,1,0,1,1,1,1,1,0,25,0,3163,0
LRoger_Arq,LRoger_Arq,,0,2,2,0,2,2,1,1,1,0,213,0,3164,0
nyctoaroace,nyctoaroace,,0,1,1,0,1,1,1,1,1,0,213,0,3165,0
maricotinhajdv,maricotinhajdv,,0,1,1,0,1,1,1,1,1,0,229,0,3166,0
zeca_dirceu,zeca_dirceu,,6,0,6,6,0,6,0,0,0,0,229,0,333,0
DPonchio,DPonchio,,0,1,1,0,1,1,1,1,1,0,213,0,3167,0
RafaelZambelli,RafaelZambelli,,0,1,1,0,1,1,1,1,1,0,213,0,3168,0
HodenikVania,HodenikVania,,0,1,1,0,1,1,1,1,1,0,213,0,3169,0
MIGUXAHEOLI,MIGUXAHEOLI,,0,1,1,0,1,1,1,1,1,0,25,0,3170,0
DomBaruque,DomBaruque,,0,1,1,0,1,1,1,1,1,0,25,0,3171,0
alessandrapesi,alessandrapesi,,0,1,1,0,1,1,2,0.666667,0.75,0,0,0,3172,0
AlexAlcantara8,AlexAlcantara8,,0,1,1,0,1,1,1,1,1,0,25,0,3173,0
otaviodecarva12,otaviodecarva12,,0,1,1,0,1,1,1,1,1,0,25,0,3174,0
FlavioRoMart,FlavioRoMart,,0,1,1,0,1,1,1,1,1,0,25,0,3175,0
MDilza,MDilza,,0,1,1,0,1,1,1,1,1,0,25,0,3176,0
VALERIAMINCHER2,VALERIAMINCHER2,,0,1,1,0,1,1,1,1,1,0,25,0,3177,0
carolaf88,carolaf88,,2,0,2,2,0,2,0,0,0,0,0,0,114,0.5
GeovaniGSo,GeovaniGSo,,0,1,1,0,1,1,1,1,1,0,25,0,3178,0
SuspensoTuiter,SuspensoTuiter,,0,1,1,0,1,1,1,1,1,0,25,0,3179,0
ElainePrudente,ElainePrudente,,0,1,1,0,1,1,1,1,1,0,25,0,3180,0
adriano_c4,adriano_c4,,0,1,1,0,1,1,1,1,1,0,25,0,3181,0
silasribasv2,silasribasv2,,0,1,1,0,1,1,1,1,1,0,25,0,3182,0
Miguelsantos38,Miguelsantos38,,0,1,1,0,1,1,1,1,1,0,25,0,3183,0
CidadaoRenan,CidadaoRenan,,0,1,1,0,1,1,1,1,1,0,25,0,3184,0
Roberto81728361,Roberto81728361,,0,1,1,0,1,1,1,1,1,0,25,0,3185,0
DePratavieira,DePratavieira,,0,1,1,0,1,1,1,1,1,0,25,0,3186,0
crazyfogo,crazyfogo,,0,1,1,0,1,1,1,1,1,0,213,0,3187,0
AngelaAugusta5,AngelaAugusta5,,0,1,1,0,1,1,1,1,1,0,25,0,3188,0
DanniCristtin,DanniCristtin,,0,1,1,0,1,1,1,1,1,0,76,0,3189,0
SidneidaCostaM1,SidneidaCostaM1,,0,1,1,0,1,1,1,1,1,0,213,0,3190,0
IbiunaCamara,IbiunaCamara,,0,1,1,0,1,1,1,1,1,0,76,0,3191,0
Gabriel80383146,Gabriel80383146,,0,1,1,0,1,1,1,1,1,0,213,0,3192,0
drrondojr,drrondojr,,1,0,1,1,0,1,0,0,0,0,0,0,113,0
justaliberdade,justaliberdade,,1,2,3,1,2,3,1,1,1,0,10,0,336,0.333333
joao_jb22,joao_jb22,,2,0,2,2,0,2,0,0,0,0,10,0,335,0.5
ddsilva01,ddsilva01,,0,1,1,0,1,1,1,1,1,0,230,188,3194,0
GProgramadora,GProgramadora,,2,0,2,2,0,2,0,0,0,0,230,188,3193,0
Rsregina16,Rsregina16,,0,1,1,0,1,1,1,1,1,0,25,0,3195,0
PauloAr53904944,PauloAr53904944,,0,1,1,0,1,1,1,1,1,0,25,0,3196,0
EmmanueldeMesq1,EmmanueldeMesq1,,0,1,1,0,1,1,1,1,1,0,25,0,3197,0
franklinpercus1,franklinpercus1,,0,1,1,0,1,1,1,1,1,0,25,0,3198,0
bonnieximena,bonnieximena,,0,1,1,0,1,1,1,1,1,0,25,0,3199,0
cenouraaaaa,cenouraaaaa,,0,1,1,0,1,1,1,1,1,0,230,188,3200,0
CamaradaMarta,CamaradaMarta,,0,1,1,0,1,1,2,0.545455,0.583333,0,10,0,3201,0
Jeffrey50858142,Jeffrey50858142,,0,1,1,0,1,1,1,1,1,0,71,0,3202,0
EliOliv98248502,EliOliv98248502,,0,1,1,0,1,1,1,1,1,0,25,0,3203,0
DiegoRi66068907,DiegoRi66068907,,0,1,1,0,1,1,1,1,1,0,25,0,3204,0
TelmaRo38433072,TelmaRo38433072,,0,1,1,0,1,1,1,1,1,0,25,0,3205,0
tuninhobrasil,tuninhobrasil,,0,1,1,0,1,1,1,1,1,0,25,0,3206,0
edgard_couto,edgard_couto,,0,1,1,0,1,1,1,1,1,0,213,0,3207,0
EnoqueLourenco,EnoqueLourenco,,0,1,1,0,1,1,1,1,1,0,25,0,3208,0
kassatti,kassatti,,0,1,1,0,1,1,1,1,1,0,25,0,3209,0
CongressoemFogo,CongressoemFogo,,0,1,1,0,1,1,1,1,1,0,25,0,3210,0
MancheteReal,MancheteReal,,0,1,1,0,1,1,1,1,1,0,25,0,3211,0
itamarbraga,itamarbraga,,0,1,1,0,1,1,1,1,1,0,25,0,3212,0
dsafre3,dsafre3,,0,1,1,0,1,1,1,1,1,0,25,0,3213,0
erivaldobsa,erivaldobsa,,0,1,1,0,1,1,1,1,1,0,25,0,3214,0
fabiolafonte1,fabiolafonte1,,0,1,1,0,1,1,1,1,1,0,213,0,3215,0
SergioWeinhard1,SergioWeinhard1,,0,1,1,0,1,1,1,1,1,0,25,0,3216,0
PAULONETO231267,PAULONETO231267,,0,1,1,0,1,1,1,1,1,0,25,0,3217,0
MarllaAquino,MarllaAquino,,0,1,1,0,1,1,1,1,1,0,213,0,3218,0
Rosimeyre2120,Rosimeyre2120,,0,1,1,0,1,1,1,1,1,0,25,0,3219,0
SilvioC68090247,SilvioC68090247,,0,1,1,0,1,1,1,1,1,0,25,0,3220,0
Spacelad43,Spacelad43,,0,1,1,0,1,1,1,1,1,0,25,0,3221,0
Robert_jus,Robert_jus,,0,1,1,0,1,1,1,1,1,0,25,0,3222,0
EderGSantos1,EderGSantos1,,0,1,1,0,1,1,1,1,1,0,25,0,3223,0
SturmEgon,SturmEgon,,0,1,1,0,1,1,1,1,1,0,25,0,3224,0
JeandoCouto,JeandoCouto,,0,1,1,0,1,1,1,1,1,0,25,0,3225,0
jorgegjardim,jorgegjardim,,0,1,1,0,1,1,1,1,1,0,25,0,3226,0
ThaCuriosa,ThaCuriosa,,0,1,1,0,1,1,1,1,1,0,25,0,3227,0
Rosianenpantoja,Rosianenpantoja,,0,1,1,0,1,1,1,1,1,0,25,0,3228,0
motatoon81,motatoon81,,0,1,1,0,1,1,1,1,1,0,25,0,3229,0
RoseMarcondes12,RoseMarcondes12,,0,1,1,0,1,1,1,1,1,0,25,0,3230,0
FederalAgent7,FederalAgent7,,0,1,1,0,1,1,1,1,1,0,25,0,3231,0
Carlos13ou13,Carlos13ou13,,0,1,1,0,1,1,1,1,1,0,213,0,3232,0
kikipenna,kikipenna,,0,1,1,0,1,1,1,1,1,0,25,0,3233,0
luigi_cardeles,luigi_cardeles,,0,1,1,0,1,1,1,1,1,0,213,0,3234,0
FabioRenatoCos1,FabioRenatoCos1,,0,1,1,0,1,1,1,1,1,0,25,0,3235,0
mauromdsd,mauromdsd,,0,1,1,0,1,1,1,1,1,0,25,0,3236,0
Nina81144782,Nina81144782,,0,1,1,0,1,1,1,1,1,0,25,0,3237,0
L_Samueloficial,L_Samueloficial,,0,1,1,0,1,1,1,1,1,0,229,0,3238,0
MonK3y_74,MonK3y_74,,0,3,3,0,3,3,1,1,1,0,231,189,3242,0
GeekZoneGZ,GeekZoneGZ,,1,0,1,1,0,1,0,0,0,0,231,189,3241,0
LBeskar,LBeskar,,1,0,1,1,0,1,0,0,0,0,231,189,3240,0
StarWarsSpain,StarWarsSpain,,1,0,1,1,0,1,0,0,0,0,231,189,3239,0
MineOrion,MineOrion,,0,2,2,0,2,2,1,1,1,0,50,0,3243,0
algaldino_,algaldino_,,0,1,1,0,1,1,1,1,1,0,213,0,3244,0
MariaLi25598068,MariaLi25598068,,0,1,1,0,1,1,1,1,1,0,213,0,3245,0
MariliaMoscou,MariliaMoscou,,0,1,1,0,1,1,1,1,1,0,213,0,3246,0
sergiorauber,sergiorauber,,0,2,2,0,2,2,1,1,1,0,88,0,3247,0
Suzyoli,Suzyoli,,0,1,1,0,1,1,1,1,1,0,213,0,3248,0
AndreLamas,AndreLamas,,0,1,1,0,1,1,1,1,1,0,213,0,3249,0
lsfortes,lsfortes,,0,1,1,0,1,1,1,1,1,0,25,0,3250,0
marcelaslobo,marcelaslobo,,0,1,1,0,1,1,1,1,1,0,213,0,3251,0
UTAD_RS,UTAD_RS,,1,0,1,1,0,1,0,0,0,0,31,0,272,0
norisregina,norisregina,,0,1,1,0,1,1,1,1,1,0,25,0,3252,0
Aguiler67754476,Aguiler67754476,,0,1,1,0,1,1,1,1,1,0,213,0,3253,0
Helena77891595,Helena77891595,,0,1,1,0,1,1,1,1,1,0,25,0,3254,0
eduardo_valente,eduardo_valente,,0,1,1,0,1,1,1,1,1,0,213,0,3255,0
Maralfv,Maralfv,,0,1,1,0,1,1,1,1,1,0,25,0,3256,0
CatitaSan61,CatitaSan61,,0,1,1,0,1,1,1,1,1,0,25,0,3257,0
Robsonaro,Robsonaro,,0,1,1,0,1,1,1,1,1,0,25,0,3258,0
Consuel41978626,Consuel41978626,,0,1,1,0,1,1,1,1,1,0,25,0,3259,0
porto_ercole,porto_ercole,,0,1,1,0,1,1,1,1,1,0,213,0,3260,0
FernandaDemtri2,FernandaDemtri2,,0,1,1,0,1,1,1,1,1,0,25,0,3261,0
cleofraga,cleofraga,,0,1,1,0,1,1,1,1,1,0,213,0,3262,0
ServioTul10,ServioTul10,,0,1,1,0,1,1,1,1,1,0,25,0,3263,0
Censura94374125,Censura94374125,,0,1,1,0,1,1,1,1,1,0,25,0,3264,0
MariaEdileneda4,MariaEdileneda4,,0,1,1,0,1,1,1,1,1,0,229,0,3265,0
Grfuracao,Grfuracao,,0,1,1,0,1,1,1,1,1,0,25,0,3266,0
FelipeF92635523,FelipeF92635523,,0,1,1,0,1,1,1,1,1,0,229,0,3267,0
_1000tao_,_1000tao_,,0,1,1,0,1,1,1,1,1,0,229,0,3268,0
marialucialeite,marialucialeite,,0,1,1,0,1,1,1,1,1,0,213,0,3269,0
HanzenPinna,HanzenPinna,,0,1,1,0,1,1,1,1,1,0,25,0,3270,0
anne_gomes,anne_gomes,,0,1,1,0,1,1,1,1,1,0,25,0,3271,0
Vida60445571,Vida60445571,,0,1,1,0,1,1,1,1,1,0,213,0,3272,0
APaula51,APaula51,,0,1,1,0,1,1,1,1,1,0,213,0,3273,0
Jusantoliv,Jusantoliv,,0,1,1,0,1,1,1,1,1,0,25,0,3274,0
anaferrazabreu,anaferrazabreu,,0,1,1,0,1,1,1,1,1,0,8,0,3275,0
ASSISRAMOS,ASSISRAMOS,,0,1,1,0,1,1,1,1,1,0,25,0,3276,0
crisvela78,crisvela78,,0,1,1,0,1,1,1,1,1,0,25,0,3277,0
GuilhermeGalo83,GuilhermeGalo83,,0,1,1,0,1,1,1,1,1,0,25,0,3278,0
Jeffers83781610,Jeffers83781610,,0,1,1,0,1,1,1,1,1,0,25,0,3279,0
Valter11239931,Valter11239931,,0,1,1,0,1,1,1,1,1,0,25,0,3280,0
yasmin38conta2,yasmin38conta2,,0,1,1,0,1,1,1,1,1,0,25,0,3281,0
Marlise57669719,Marlise57669719,,0,1,1,0,1,1,1,1,1,0,25,0,3282,0
Sc76Adriano,Sc76Adriano,,0,1,1,0,1,1,1,1,1,0,25,0,3283,0
Jornal_Canyons,Jornal_Canyons,,1,0,1,1,0,1,0,0,0,0,10,0,332,0
AndersonMA1984,AndersonMA1984,,0,1,1,0,1,1,1,1,1,0,25,0,3284,0
Dealeitao,Dealeitao,,0,1,1,0,1,1,2,0.545455,0.583333,0,10,0,3285,0
IzzieGui,IzzieGui,,0,1,1,0,1,1,2,0.545455,0.583333,0,10,0,3286,0
Mariada25948049,Mariada25948049,,0,1,1,0,1,1,1,1,1,0,25,0,3287,0
ERuiFranco,ERuiFranco,,0,1,1,0,1,1,1,1,1,0,25,0,3288,0
CelsoRock1,CelsoRock1,,0,1,1,0,1,1,1,1,1,0,25,0,3289,0
GilsonF61987901,GilsonF61987901,,0,1,1,0,1,1,2,0.526316,0.55,0,57,0,3290,0
rosahst,rosahst,,0,1,1,0,1,1,1,1,1,0,25,0,3291,0
vivanossavida,vivanossavida,,0,1,1,0,1,1,2,0.526316,0.55,0,57,0,3292,0
Ferreira3077,Ferreira3077,,0,1,1,0,1,1,1,1,1,0,25,0,3293,0
avaldetaro,avaldetaro,,0,1,1,0,1,1,1,1,1,0,25,0,3294,0
alvesgerluce,alvesgerluce,,0,2,2,0,2,2,2,0.75,0.833333,0,76,0,3296,0.5
Oaps_saude,Oaps_saude,,1,2,3,1,3,4,1,1,1,0,76,0,3295,0.5
MasdianTelas,MasdianTelas,,0,1,1,0,1,1,1,1,1,0,25,0,3297,0
cleocostta,cleocostta,,0,1,1,0,1,1,1,1,1,0,25,0,3298,0
andreamgb,andreamgb,,0,1,1,0,1,1,1,1,1,0,25,0,3299,0
AlineTLSaoPaulo,AlineTLSaoPaulo,,0,1,1,0,1,1,1,1,1,0,213,0,3300,0
Doutora_Monica,Doutora_Monica,,0,1,1,0,1,1,1,1,1,0,25,0,3301,0
edudurio,edudurio,,0,1,1,0,1,1,1,1,1,0,25,0,3302,0
ApoloCosta,ApoloCosta,,0,1,1,0,1,1,1,1,1,0,25,0,3303,0
lvaroGabrielCo1,lvaroGabrielCo1,,0,1,1,0,1,1,1,1,1,0,25,0,3304,0
GilmarRPinheiro,GilmarRPinheiro,,0,1,1,0,1,1,1,1,1,0,25,0,3305,0
Gersonfersfilho,Gersonfersfilho,,0,1,1,0,1,1,1,1,1,0,25,0,3306,0
Jbbh71875206,Jbbh71875206,,0,1,1,0,1,1,1,1,1,0,213,0,3307,0
jornalx,jornalx,,0,1,1,0,1,1,1,1,1,0,213,0,3308,0
MacosHenrique2,MacosHenrique2,,0,1,1,0,1,1,1,1,1,0,25,0,3309,0
UniversoQ1,UniversoQ1,,0,1,1,0,1,1,1,1,1,0,25,0,3310,0
carlos_brindes,carlos_brindes,,0,1,1,0,1,1,1,1,1,0,232,190,3312,0
portelinhabrind,portelinhabrind,,1,0,1,1,0,1,0,0,0,0,232,190,3311,0
EduardoCristao2,EduardoCristao2,,0,1,1,0,1,1,1,1,1,0,4,0,3313,0
1josebr,1josebr,,0,2,2,0,2,2,2,0.583333,0.642857,0,213,0,3314,0
akira_pinto,akira_pinto,,0,1,1,0,1,1,1,1,1,0,213,0,3315,0
AntonioMaanves,AntonioMaanves,,0,1,1,0,1,1,1,1,1,0,25,0,3316,0
TheRabbitHRole,TheRabbitHRole,,0,1,1,0,1,1,1,1,1,0,25,0,3317,0
MacielAureo,MacielAureo,,0,2,2,0,2,2,1,1,1,0,50,0,3318,0
SueliFigueired,SueliFigueired,,0,1,1,0,1,1,1,1,1,0,25,0,3319,0
PatriaAmada0709,PatriaAmada0709,,0,1,1,0,1,1,1,1,1,0,25,0,3320,0
SBTonline,SBTonline,,0,1,1,0,5,5,1,1,1,0,0,0,3321,0
ForrestGumpRea1,ForrestGumpRea1,,0,1,1,0,1,1,1,1,1,0,25,0,3322,0
junior_gedi,junior_gedi,,0,1,1,0,1,1,1,1,1,0,25,0,3323,0
Elizabettamura,Elizabettamura,,0,1,1,0,1,1,1,1,1,0,25,0,3324,0
bitenvida,bitenvida,,0,1,1,0,1,1,1,1,1,0,25,0,3325,0
avcnarrador,avcnarrador,,0,1,1,0,1,1,1,1,1,0,233,191,3327,0
novacuo,novacuo,,1,0,1,1,0,1,0,0,0,0,233,191,3326,0
marciamonteiro,marciamonteiro,,0,1,1,0,1,1,1,1,1,0,25,0,3328,0
4Mey_7,4Mey_7,,0,1,1,0,1,1,1,1,1,0,25,0,3329,0
GuilhermeSPD_MD,GuilhermeSPD_MD,,0,1,1,0,1,1,1,1,1,0,25,0,3330,0
WJO_SP,WJO_SP,,0,2,2,0,2,2,1,1,1,0,25,0,3332,0
PandocaBr,PandocaBr,,0,1,1,0,1,1,1,1,1,0,25,0,3333,0
EstudioMMDC,EstudioMMDC,,0,1,1,0,1,1,1,1,1,0,25,0,3334,0
flaviahelenap,flaviahelenap,,0,1,1,0,1,1,1,1,1,0,25,0,3335,0
Juarez97163035,Juarez97163035,,0,1,1,0,1,1,1,1,1,0,25,0,3336,0
AnaMaraRamrezM4,AnaMaraRamrezM4,,0,1,1,0,1,1,1,1,1,0,29,0,3337,0
tiabili,tiabili,,0,1,1,0,1,1,1,1,1,0,25,0,3338,0
Jones93515167,Jones93515167,,0,1,1,0,1,1,1,1,1,0,213,0,3339,0
EdisonVHG,EdisonVHG,,0,1,1,0,1,1,1,1,1,0,41,0,3340,0
AndrRoq31371572,AndrRoq31371572,,0,1,1,0,1,1,1,1,1,0,25,0,3341,0
anacouer76,anacouer76,,0,1,1,0,1,1,1,1,1,0,213,0,3342,0
dricapsbranco,dricapsbranco,,0,1,1,0,1,1,1,1,1,0,25,0,3343,0
anacaroldemelo,anacaroldemelo,,0,1,1,0,1,1,1,1,1,0,213,0,3344,0
lesexbian,lesexbian,,0,1,1,0,1,1,1,1,1,0,213,0,3345,0
FernandoLiber15,FernandoLiber15,,0,1,1,0,1,1,1,1,1,0,25,0,3346,0
sau_ivani,sau_ivani,,0,1,1,0,1,1,1,1,1,0,25,0,3347,0
PatriotaOnline,PatriotaOnline,,0,1,1,0,1,1,1,1,1,0,25,0,3348,0
DenisonFelix,DenisonFelix,,0,1,1,0,1,1,1,1,1,0,25,0,3349,0
juliocjacob,juliocjacob,,0,1,1,0,1,1,1,1,1,0,25,0,3350,0
LewithLuv,LewithLuv,,0,1,1,0,1,1,1,1,1,0,213,0,3351,0
RoseMovio,RoseMovio,,0,1,1,0,1,1,1,1,1,0,25,0,3352,0
lucearaujo,lucearaujo,,0,1,1,0,1,1,1,1,1,0,25,0,3353,0
Nina62517068,Nina62517068,,0,1,1,0,1,1,1,1,1,0,25,0,3354,0
Lola18919951,Lola18919951,,0,1,1,0,3,3,2,0.545455,0.583333,0,10,0,3355,0
rone_sbo,rone_sbo,,0,1,1,0,1,1,1,1,1,0,25,0,3356,0
joaosergio,joaosergio,,0,1,1,0,1,1,1,1,1,0,213,0,3357,0
crf_rikdavid,crf_rikdavid,,0,1,1,0,1,1,1,1,1,0,25,0,3358,0
Mikajp4,Mikajp4,,0,1,1,0,1,1,1,1,1,0,25,0,3359,0
1984Patriota,1984Patriota,,0,1,1,0,1,1,1,1,1,0,25,0,3360,0
MAUROHEXAGONO,MAUROHEXAGONO,,0,1,1,0,1,1,1,1,1,0,25,0,3361,0
PensadorNordest,PensadorNordest,,0,1,1,0,1,1,1,1,1,0,213,0,3362,0
RochaShenia,RochaShenia,,0,1,1,0,1,1,1,1,1,0,25,0,3363,0
cristinacosta22,cristinacosta22,,0,1,1,0,1,1,1,1,1,0,25,0,3364,0
claracomosou,claracomosou,,0,1,1,0,1,1,1,1,1,0,213,0,3365,0
LouraBrasil,LouraBrasil,,0,1,1,0,1,1,1,1,1,0,25,0,3366,0
howtobeswiftie,howtobeswiftie,,0,1,1,0,1,1,1,1,1,0,213,0,3367,0
jantoniocs29,jantoniocs29,,0,1,1,0,1,1,1,1,1,0,25,0,3368,0
AzevedoGmai,AzevedoGmai,,0,1,1,0,1,1,1,1,1,0,25,0,3369,0
ceruliansky1,ceruliansky1,,0,1,1,0,1,1,1,1,1,0,25,0,3370,0
DaniloJA2001,DaniloJA2001,,0,1,1,0,1,1,1,1,1,0,25,0,3371,0
valepolitica,valepolitica,,0,1,1,0,1,1,1,1,1,0,213,0,3372,0
Drakos_EJuices,Drakos_EJuices,,0,1,1,0,1,1,1,1,1,0,25,0,3373,0
marceloverly,marceloverly,,0,1,1,0,1,1,1,1,1,0,213,0,3374,0
jullyy_h,jullyy_h,,0,1,1,0,1,1,1,1,1,0,213,0,3375,0
hugo_quimica9,hugo_quimica9,,0,1,1,0,1,1,1,1,1,0,213,0,3376,0
AnaMariaRossat9,AnaMariaRossat9,,0,1,1,0,1,1,1,1,1,0,25,0,3377,0
jorgealen,jorgealen,,0,1,1,0,1,1,1,1,1,0,25,0,3378,0
CarlosL38741447,CarlosL38741447,,0,1,1,0,1,1,1,1,1,0,25,0,3379,0
exploradigital_,exploradigital_,,3,0,3,12,0,12,0,0,0,0,45,0,29,0.5
SandraRezende17,SandraRezende17,,0,1,1,0,1,1,1,1,1,0,25,0,3380,0
CrystalTypewri1,CrystalTypewri1,,0,1,1,0,1,1,1,1,1,0,25,0,3381,0
Freitas_DRJ,Freitas_DRJ,,0,3,3,0,3,3,1,1,1,0,76,0,3382,0.333333
Siliane18,Siliane18,,0,1,1,0,1,1,1,1,1,0,25,0,3383,0
brunoleoaguiar,brunoleoaguiar,,0,1,1,0,1,1,1,1,1,0,25,0,3384,0
NilzaFerreiraR4,NilzaFerreiraR4,,0,1,1,0,1,1,1,1,1,0,25,0,3385,0
MariaCapitu2,MariaCapitu2,,0,1,1,0,1,1,1,1,1,0,213,0,3386,0
CiudadanoF,CiudadanoF,,0,1,1,0,1,1,1,1,1,0,29,0,3387,0
ba_hage,ba_hage,,0,1,1,0,1,1,1,1,1,0,213,0,3388,0
RegianeSFurtado,RegianeSFurtado,,0,1,1,0,1,1,1,1,1,0,25,0,3389,0
Rosemei34368445,Rosemei34368445,,0,1,1,0,1,1,1,1,1,0,25,0,3390,0
auguriba,auguriba,,0,1,1,0,1,1,1,1,1,0,213,0,3391,0
DoraBorges4,DoraBorges4,,0,1,1,0,1,1,1,1,1,0,25,0,3392,0
hanumancoin,hanumancoin,,0,1,1,0,1,1,1,1,1,0,25,0,3393,0
TaniaMorae4,TaniaMorae4,,0,1,1,0,1,1,1,1,1,0,213,0,3394,0
Luizottoni1,Luizottoni1,,0,1,1,0,1,1,1,1,1,0,25,0,3395,0
PollyInTheSky__,PollyInTheSky__,,0,1,1,0,1,1,1,1,1,0,213,0,3396,0
DennisTravesso,DennisTravesso,,0,1,1,0,1,1,1,1,1,0,213,0,3397,0
deb156411,deb156411,,0,1,1,0,1,1,1,1,1,0,25,0,3398,0
Ricardo40506679,Ricardo40506679,,0,1,1,0,1,1,1,1,1,0,25,0,3399,0
hottoleao,hottoleao,,0,1,1,0,1,1,1,1,1,0,25,0,3400,0
portugues19791,portugues19791,,0,1,1,0,1,1,1,1,1,0,25,0,3401,0
JussaraAnderso6,JussaraAnderso6,,0,1,1,0,1,1,1,1,1,0,25,0,3402,0
Moreirinha73,Moreirinha73,,0,1,1,0,1,1,1,1,1,0,25,0,3403,0
adailoguia,adailoguia,,0,1,1,0,1,1,1,1,1,0,25,0,3404,0
CoxinhaBaiana,CoxinhaBaiana,,0,1,1,0,1,1,1,1,1,0,25,0,3405,0
Catarinagoias,Catarinagoias,,0,1,1,0,1,1,1,1,1,0,25,0,3406,0
Leonard_ventur,Leonard_ventur,,0,1,1,0,1,1,1,1,1,0,25,0,3407,0
JeanFabricioCo1,JeanFabricioCo1,,0,1,1,0,1,1,1,1,1,0,25,0,3408,0
JanicedeMeloVi2,JanicedeMeloVi2,,0,1,1,0,1,1,1,1,1,0,25,0,3409,0
adrianoluiz1909,adrianoluiz1909,,0,1,1,0,1,1,1,1,1,0,25,0,3410,0
JlioCsa02370805,JlioCsa02370805,,0,1,1,0,1,1,1,1,1,0,25,0,3411,0
Linguapressa,Linguapressa,,0,1,1,0,1,1,1,1,1,0,19,0,3412,0
LaLeocadia,LaLeocadia,,0,1,1,0,1,1,1,1,1,0,19,0,3413,0
Amanda00948418,Amanda00948418,,0,1,1,0,1,1,1,1,1,0,25,0,3414,0
LindalvaGomes9,LindalvaGomes9,,0,1,1,0,1,1,1,1,1,0,25,0,3415,0
velcreiro,velcreiro,,0,1,1,0,1,1,2,0.545455,0.583333,0,10,0,3416,0
SVieirapg,SVieirapg,,0,1,1,0,1,1,1,1,1,0,213,0,3417,0
MarcosRomuloMr,MarcosRomuloMr,,0,1,1,0,1,1,1,1,1,0,25,0,3418,0
dudu_santana05,dudu_santana05,,0,1,1,0,1,1,1,1,1,0,25,0,3419,0
pai_naldo,pai_naldo,,0,1,1,0,1,1,1,1,1,0,213,0,3420,0
Cleiton58410322,Cleiton58410322,,0,1,1,0,1,1,1,1,1,0,25,0,3421,0
PDamiance,PDamiance,,0,1,1,0,1,1,1,1,1,0,213,0,3422,0
elianeg1963,elianeg1963,,0,1,1,0,1,1,1,1,1,0,25,0,3423,0
GuilhermeAdePe1,GuilhermeAdePe1,,0,1,1,0,1,1,1,1,1,0,213,0,3424,0
PulmaoSA,PulmaoSA,,0,4,4,0,4,4,1,1,1,0,28,0,3427,0
PneumoPR,PneumoPR,,1,0,1,1,0,1,0,0,0,0,28,0,3426,0
MCharles_SO,MCharles_SO,,0,1,1,0,1,1,1,1,1,0,25,0,3428,0
CarolRi92672510,CarolRi92672510,,0,1,1,0,1,1,1,1,1,0,25,0,3429,0
Andre_LIBERDADE,Andre_LIBERDADE,,1,0,1,1,0,1,0,0,0,0,94,61,1383,0
BolsoPatriota22,BolsoPatriota22,,1,0,1,1,0,1,0,0,0,0,94,61,1382,0
FrancescaFrei10,FrancescaFrei10,,0,1,1,0,1,1,1,1,1,0,25,0,3430,0
suani_pilau,suani_pilau,,0,1,1,0,1,1,1,1,1,0,25,0,3431,0
AMSKBrasil,AMSKBrasil,,0,1,1,0,1,1,1,1,1,0,213,0,3432,0
alexand46154681,alexand46154681,,0,1,1,0,1,1,1,1,1,0,25,0,3433,0
MicheleNRA,MicheleNRA,,0,1,1,0,1,1,1,1,1,0,25,0,3434,0
_conservado,_conservado,,0,1,1,0,1,1,1,1,1,0,25,0,3435,0
CristianaFc,CristianaFc,,0,2,2,0,2,2,1,1,1,0,213,0,3436,0
LaneBatista5,LaneBatista5,,0,1,1,0,1,1,1,1,1,0,25,0,3437,0
anaprofbrasil,anaprofbrasil,,0,1,1,0,1,1,1,1,1,0,25,0,3438,0
almagnolima,almagnolima,,0,1,1,0,1,1,1,1,1,0,25,0,3439,0
Erdpatriota,Erdpatriota,,0,1,1,0,1,1,1,1,1,0,25,0,3440,0
PaulinhoDJ,PaulinhoDJ,,0,1,1,0,1,1,1,1,1,0,25,0,3441,0
Giovana64750293,Giovana64750293,,0,1,1,0,2,2,1,1,1,0,25,0,3442,0
SantosMScliche,SantosMScliche,,0,1,1,0,1,1,1,1,1,0,25,0,3443,0
Roberta64284151,Roberta64284151,,0,1,1,0,1,1,1,1,1,0,25,0,3444,0
simona1966,simona1966,,0,1,1,0,1,1,1,1,1,0,25,0,3445,0
LanePereira14,LanePereira14,,0,1,1,0,1,1,1,1,1,0,25,0,3446,0
lucianamarmol,lucianamarmol,,0,1,1,0,1,1,1,1,1,0,25,0,3447,0
Elenkhs1,Elenkhs1,,0,1,1,0,1,1,1,1,1,0,25,0,3448,0
exercittoleitte,exercittoleitte,,1,0,1,1,0,1,0,0,0,0,10,0,331,0
dorinha91,dorinha91,,0,1,1,0,1,1,1,1,1,0,213,0,3449,0
Saldanha_BrasiI,Saldanha_BrasiI,,0,1,1,0,1,1,1,1,1,0,25,0,3450,0
NEJM,NEJM,,1,0,1,1,0,1,0,0,0,0,28,0,3425,0
Melissa86030229,Melissa86030229,,0,1,1,0,1,1,1,1,1,0,25,0,3451,0
hugomouraJPA,hugomouraJPA,,0,1,1,0,1,1,1,1,1,0,25,0,3452,0
dloliveira1830,dloliveira1830,,0,1,1,0,1,1,1,1,1,0,25,0,3453,0
annbarretto_,annbarretto_,,0,1,1,0,1,1,1,1,1,0,213,0,3454,0
Josemar_Rodrigu,Josemar_Rodrigu,,0,1,1,0,1,1,1,1,1,0,25,0,3455,0
ThiagoBrutus,ThiagoBrutus,,0,1,1,0,1,1,1,1,1,0,25,0,3456,0
Ryttah70,Ryttah70,,0,1,1,0,1,1,1,1,1,0,25,0,3457,0
elisonfurlan,elisonfurlan,,0,1,1,0,2,2,1,1,1,0,25,0,3458,0
fabio_quinteiro,fabio_quinteiro,,0,1,1,0,1,1,1,1,1,0,25,0,3459,0
seraphcaos,seraphcaos,,0,1,1,0,1,1,1,1,1,0,213,0,3460,0
rblondt,rblondt,,0,1,1,0,1,1,1,1,1,0,25,0,3461,0
oscarcapella,oscarcapella,,0,1,1,0,1,1,1,1,1,0,25,0,3462,0
flaviopsilva_,flaviopsilva_,,0,1,1,0,1,1,1,1,1,0,25,0,3463,0
CrispatriaBR,CrispatriaBR,,0,1,1,0,1,1,1,1,1,0,25,0,3464,0
derf_odeveza,derf_odeveza,,0,1,1,0,1,1,1,1,1,0,213,0,3465,0
prtleosouza,prtleosouza,,0,1,1,0,1,1,1,1,1,0,25,0,3466,0
MTh4is,MTh4is,,0,1,1,0,1,1,1,1,1,0,213,0,3467,0
mateYmorra,mateYmorra,,0,1,1,0,1,1,1,1,1,0,213,0,3468,0
marcelofi1978,marcelofi1978,,0,1,1,0,1,1,1,1,1,0,25,0,3469,0
j_amaro,j_amaro,,0,1,1,0,1,1,1,1,1,0,25,0,3470,0
Neyla30126745,Neyla30126745,,0,1,1,0,1,1,1,1,1,0,25,0,3471,0
Dodo_PO,Dodo_PO,,0,1,1,0,1,1,1,1,1,0,25,0,3472,0
alissonpantuza,alissonpantuza,,0,1,1,0,1,1,1,1,1,0,25,0,3473,0
TatianeWest,TatianeWest,,0,1,1,0,1,1,1,1,1,0,25,0,3474,0
cristiano_lana,cristiano_lana,,0,1,1,0,1,1,1,1,1,0,25,0,3475,0
Victor_rjolv,Victor_rjolv,,0,1,1,0,1,1,1,1,1,0,25,0,3476,0
ladodpatriota,ladodpatriota,,0,1,1,0,1,1,1,1,1,0,25,0,3477,0
mtcosmo1,mtcosmo1,,0,2,2,0,2,2,1,1,1,0,50,0,3478,0
Alessan12225995,Alessan12225995,,0,1,1,0,1,1,1,1,1,0,25,0,3479,0
lftav2,lftav2,,0,1,1,0,1,1,1,1,1,0,25,0,3480,0
Luciane43533166,Luciane43533166,,0,1,1,0,1,1,1,1,1,0,25,0,3481,0
Antonio91152382,Antonio91152382,,0,1,1,0,1,1,1,1,1,0,25,0,3482,0
carlosedumuller,carlosedumuller,,0,1,1,0,1,1,2,0.545455,0.583333,0,10,0,3483,0
tchunay1984,tchunay1984,,0,1,1,0,1,1,1,1,1,0,25,0,3484,0
Luiz_didu,Luiz_didu,,0,1,1,0,1,1,1,1,1,0,25,0,3485,0
almasebosa,almasebosa,,0,1,1,0,1,1,2,0.545455,0.583333,0,10,0,3486,0
AdrianaGrasses2,AdrianaGrasses2,,0,1,1,0,1,1,1,1,1,0,25,0,3487,0
mullerwj,mullerwj,,0,1,1,0,1,1,1,1,1,0,25,0,3488,0
madrynha2012,madrynha2012,,0,1,1,0,1,1,1,1,1,0,25,0,3489,0
EduChimello,EduChimello,,0,1,1,0,1,1,1,1,1,0,25,0,3490,0
Ale_ABCFCBRASIL,Ale_ABCFCBRASIL,,0,1,1,0,1,1,1,1,1,0,25,0,3491,0
RafaelGrilO7,RafaelGrilO7,,0,1,1,0,1,1,1,1,1,0,25,0,3492,0
j_montsse,j_montsse,,0,1,1,0,1,1,2,0.545455,0.583333,0,10,0,3493,0
ElexandraAndrad,ElexandraAndrad,,0,1,1,0,1,1,1,1,1,0,25,0,3494,0
WiliamBamBam,WiliamBamBam,,0,1,1,0,1,1,1,1,1,0,25,0,3495,0
fbarreira,fbarreira,,0,1,1,0,1,1,1,1,1,0,25,0,3496,0
AriquermeS,AriquermeS,,0,1,1,0,1,1,1,1,1,0,25,0,3497,0
EUGENIOlimasant,EUGENIOlimasant,,0,1,1,0,1,1,1,1,1,0,25,0,3498,0
edgarciame,edgarciame,,0,1,1,0,1,1,1,1,1,0,29,0,3499,0
vrijr2012,vrijr2012,,0,1,1,0,1,1,1,1,1,0,25,0,3500,0
Juliana_Stylist,Juliana_Stylist,,0,1,1,0,1,1,1,1,1,0,25,0,3501,0
Crashvk,Crashvk,,0,1,1,0,1,1,1,1,1,0,25,0,3502,0
WillianPauloPe1,WillianPauloPe1,,0,1,1,0,2,2,2,0.545455,0.583333,0,10,0,3503,0
cris_caldeira,cris_caldeira,,0,1,1,0,1,1,1,1,1,0,25,0,3504,0
Fran_cisco_BR,Fran_cisco_BR,,0,1,1,0,1,1,1,1,1,0,25,0,3505,0
GoncaloMieco,GoncaloMieco,,0,1,1,0,1,1,1,1,1,0,25,0,3506,0
BETO40358322,BETO40358322,,0,1,1,0,1,1,1,1,1,0,41,0,3507,0
danijanene1,danijanene1,,0,1,1,0,1,1,1,1,1,0,25,0,3508,0
CunhaLucare,CunhaLucare,,0,1,1,0,1,1,1,1,1,0,25,0,3509,0
VisitanteCg,VisitanteCg,,0,1,1,0,1,1,1,1,1,0,25,0,3510,0
OsmarTomi,OsmarTomi,,0,1,1,0,1,1,1,1,1,0,25,0,3511,0
Osever111,Osever111,,0,1,1,0,1,1,1,1,1,0,25,0,3512,0
smariacamel,smariacamel,,0,1,1,0,1,1,1,1,1,0,234,192,3514,0
FabioAlexander_,FabioAlexander_,,1,0,1,1,0,1,0,0,0,0,234,192,3513,0
Eder_deAguiar,Eder_deAguiar,,0,1,1,0,1,1,1,1,1,0,25,0,3515,0
jogaucha,jogaucha,,0,1,1,0,1,1,1,1,1,0,25,0,3516,0
MarcuseJe,MarcuseJe,,0,1,1,0,1,1,1,1,1,0,25,0,3517,0
sandralife100,sandralife100,,0,1,1,0,1,1,1,1,1,0,25,0,3518,0
angelaratkie,angelaratkie,,0,3,3,0,3,3,2,0.8,0.875,0,71,0,3519,0.166667
Pedro010763,Pedro010763,,0,1,1,0,1,1,1,1,1,0,25,0,3520,0
liberdade2972,liberdade2972,,0,1,1,0,1,1,1,1,1,0,25,0,3521,0
igncio_silva,igncio_silva,,0,1,1,0,1,1,1,1,1,0,25,0,3522,0
uzumaki_shinji,uzumaki_shinji,,0,1,1,0,1,1,1,1,1,0,29,0,3523,0
josi975,josi975,,0,1,1,0,1,1,1,1,1,0,25,0,3524,0
ArcanjoMessiah,ArcanjoMessiah,,0,1,1,0,1,1,1,1,1,0,25,0,3525,0
BernardinoRosy,BernardinoRosy,,0,1,1,0,1,1,1,1,1,0,25,0,3526,0
PregoGean,PregoGean,,0,1,1,0,1,1,1,1,1,0,25,0,3527,0
luis_cap,luis_cap,,0,1,1,0,1,1,1,1,1,0,25,0,3528,0
Edivaldogo38,Edivaldogo38,,0,1,1,0,1,1,1,1,1,0,25,0,3529,0
RetornoPaulo,RetornoPaulo,,0,1,1,0,1,1,1,1,1,0,25,0,3530,0
zivioti,zivioti,,0,1,1,0,1,1,1,1,1,0,25,0,3531,0
Gerliane,Gerliane,,0,1,1,0,1,1,1,1,1,0,25,0,3532,0
vera_portas,vera_portas,,0,1,1,0,1,1,1,1,1,0,25,0,3533,0
claudia_estrel,claudia_estrel,,0,1,1,0,1,1,1,1,1,0,25,0,3534,0
brandao_geisha,brandao_geisha,,0,1,1,0,1,1,1,1,1,0,25,0,3535,0
Marioforweb,Marioforweb,,0,1,1,0,1,1,1,1,1,0,25,0,3536,0
Rodrigo2008_,Rodrigo2008_,,0,1,1,0,1,1,2,0.666667,0.75,0,76,0,3537,0
marilene_olivi,marilene_olivi,,0,1,1,0,1,1,2,0.545455,0.583333,0,10,0,3538,0
cayres_rogerio,cayres_rogerio,,0,1,1,0,1,1,1,1,1,0,25,0,3539,0
LucianoJBSanto1,LucianoJBSanto1,,0,1,1,0,1,1,1,1,1,0,25,0,3540,0
a_g_goncalves,a_g_goncalves,,0,1,1,0,1,1,1,1,1,0,25,0,3541,0
GilCesarsampaio,GilCesarsampaio,,0,1,1,0,1,1,1,1,1,0,25,0,3542,0
Fabrcicio,Fabrcicio,,0,1,1,0,1,1,1,1,1,0,25,0,3543,0
jairbianco66,jairbianco66,,0,1,1,0,1,1,1,1,1,0,25,0,3544,0
liedabarbosa,liedabarbosa,,0,1,1,0,1,1,1,1,1,0,25,0,3545,0
Izabelbelel1,Izabelbelel1,,0,1,1,0,1,1,1,1,1,0,25,0,3546,0
DiegoMeneze85,DiegoMeneze85,,0,1,1,0,1,1,1,1,1,0,25,0,3547,0
eduardoenoki,eduardoenoki,,0,1,1,0,1,1,1,1,1,0,25,0,3548,0
catia_spinelli,catia_spinelli,,0,1,1,0,1,1,1,1,1,0,25,0,3549,0
csarafim,csarafim,,0,1,1,0,1,1,1,1,1,0,25,0,3550,0
Brasilpatriota9,Brasilpatriota9,,0,1,1,0,1,1,1,1,1,0,25,0,3551,0
leovasco10,leovasco10,,0,2,2,0,2,2,1,1,1,0,80,0,3552,0
Lucas_Isaias_,Lucas_Isaias_,,0,1,1,0,1,1,1,1,1,0,25,0,3553,0
Zane83410900,Zane83410900,,0,1,1,0,1,1,1,1,1,0,25,0,3554,0
teoricoconspiro,teoricoconspiro,,0,1,1,0,1,1,1,1,1,0,25,0,3555,0
DedeAndrade12,DedeAndrade12,,0,1,1,0,1,1,1,1,1,0,25,0,3556,0
Weyllj,Weyllj,,0,1,1,0,1,1,1,1,1,0,25,0,3557,0
yasdositeBr,yasdositeBr,,0,1,1,0,1,1,1,1,1,0,25,0,3558,0
Leolabar,Leolabar,,0,1,1,0,1,1,1,1,1,0,25,0,3559,0
MelissaFelina,MelissaFelina,,0,1,1,0,1,1,1,1,1,0,25,0,3560,0
RodGalasso,RodGalasso,,0,1,1,0,1,1,1,1,1,0,25,0,3561,0
taoquei1,taoquei1,,0,1,1,0,1,1,1,1,1,0,25,0,3562,0
MR_ALTER,MR_ALTER,,0,1,1,0,1,1,1,1,1,0,25,0,3563,0
DutraSavoy,DutraSavoy,,0,1,1,0,1,1,1,1,1,0,25,0,3564,0
etcastros,etcastros,,0,1,1,0,1,1,1,1,1,0,25,0,3565,0
BarrosNereide,BarrosNereide,,0,1,1,0,1,1,1,1,1,0,25,0,3566,0
nopontodofato,nopontodofato,,0,1,1,0,1,1,1,1,1,0,25,0,3567,0
AnticomunistaGS,AnticomunistaGS,,0,1,1,0,1,1,1,1,1,0,25,0,3568,0
edevaldoolivei3,edevaldoolivei3,,0,1,1,0,1,1,1,1,1,0,25,0,3569,0
Plato14181684,Plato14181684,,0,1,1,0,1,1,1,1,1,0,25,0,3570,0
kelner_eduardo,kelner_eduardo,,0,1,1,0,1,1,1,1,1,0,25,0,3571,0
ClaudiaCanSilva,ClaudiaCanSilva,,0,1,1,0,1,1,1,1,1,0,25,0,3572,0
caroline_ayala,caroline_ayala,,0,2,2,0,2,2,1,1,1,0,76,0,3573,1
MarconiBSC,MarconiBSC,,0,1,1,0,1,1,1,1,1,0,25,0,3574,0
BGregolio,BGregolio,,0,1,1,0,1,1,1,1,1,0,25,0,3575,0
MarciaS55581046,MarciaS55581046,,0,1,1,0,1,1,1,1,1,0,25,0,3576,0
Ranieri10690411,Ranieri10690411,,0,1,1,0,1,1,1,1,1,0,25,0,3577,0
CludiaFiuza1,CludiaFiuza1,,0,1,1,0,1,1,1,1,1,0,25,0,3578,0
ErguePor,ErguePor,,0,1,1,0,1,1,1,1,1,0,235,193,3580,0
MartiniTiago,MartiniTiago,,1,0,1,1,0,1,0,0,0,0,235,193,3579,0
LuizEmanoel1017,LuizEmanoel1017,,0,1,1,0,1,1,1,1,1,0,25,0,3581,0
nir_wagner,nir_wagner,,0,1,1,0,1,1,1,1,1,0,25,0,3582,0
behdormas,behdormas,,0,1,1,0,1,1,1,1,1,0,25,0,3583,0
cissa50999370,cissa50999370,,0,1,1,0,1,1,1,1,1,0,25,0,3584,0
Leninha2022,Leninha2022,,0,1,1,0,1,1,1,1,1,0,25,0,3585,0
RoseLeites,RoseLeites,,0,1,1,0,1,1,1,1,1,0,25,0,3586,0
ZcSandro,ZcSandro,,0,1,1,0,1,1,1,1,1,0,25,0,3587,0
sf79,sf79,,0,1,1,0,1,1,1,1,1,0,25,0,3588,0
LuisPau38697413,LuisPau38697413,,0,1,1,0,1,1,1,1,1,0,25,0,3589,0
LimaJunior_BR63,LimaJunior_BR63,,0,1,1,0,1,1,1,1,1,0,25,0,3590,0
MaizaNatal,MaizaNatal,,0,1,1,0,2,2,1,1,1,0,25,0,3591,0
DrViniciusPet,DrViniciusPet,,0,1,1,0,1,1,1,1,1,0,25,0,3592,0
msp3msp,msp3msp,,0,1,1,0,1,1,1,1,1,0,25,0,3593,0
alvim_malta,alvim_malta,,0,1,1,0,1,1,1,1,1,0,25,0,3594,0
RolimSkyl,RolimSkyl,,0,1,1,0,1,1,1,1,1,0,25,0,3595,0
sgrandini,sgrandini,,0,1,1,0,1,1,1,1,1,0,25,0,3596,0
angelicaguirele,angelicaguirele,,0,3,3,0,3,3,2,0.8,0.875,0,71,0,3597,0.166667
Nivea_SpesEst,Nivea_SpesEst,,0,1,1,0,1,1,1,1,1,0,25,0,3598,0
dougporto03,dougporto03,,0,1,1,0,1,1,1,1,1,0,25,0,3599,0
Alessan21194398,Alessan21194398,,0,1,1,0,1,1,1,1,1,0,25,0,3600,0
DIEGOALANPESSO1,DIEGOALANPESSO1,,0,1,1,0,1,1,1,1,1,0,25,0,3601,0
Andr20399566,Andr20399566,,0,1,1,0,1,1,1,1,1,0,25,0,3602,0
Oingo,Oingo,,0,1,1,0,1,1,1,1,1,0,25,0,3603,0
klgil,klgil,,0,1,1,0,1,1,1,1,1,0,25,0,3604,0
MichelC29169062,MichelC29169062,,0,1,1,0,1,1,1,1,1,0,25,0,3605,0
SebastioRegina1,SebastioRegina1,,0,1,1,0,1,1,1,1,1,0,25,0,3606,0
Adrigr78,Adrigr78,,0,1,1,0,1,1,1,1,1,0,25,0,3607,0
LimaDoc,LimaDoc,,0,3,3,0,3,3,1,1,1,0,45,0,3609,0.166667
PetersonSouza81,PetersonSouza81,,0,1,1,0,1,1,1,1,1,0,236,194,3611,0
virounoticia,virounoticia,,1,0,1,1,0,1,0,0,0,0,236,194,3610,0
RubensC97124695,RubensC97124695,,0,1,1,0,1,1,1,1,1,0,25,0,3612,0
DelfrariVinny,DelfrariVinny,,0,1,1,0,1,1,1,1,1,0,25,0,3613,0
theBorba70,theBorba70,,0,1,1,0,1,1,1,1,1,0,25,0,3614,0
Andredeienno,Andredeienno,,0,1,1,0,1,1,1,1,1,0,25,0,3615,0
_Gisa___,_Gisa___,,0,1,1,0,1,1,1,1,1,0,25,0,3616,0
PoucosNao,PoucosNao,,0,1,1,0,1,1,1,1,1,0,25,0,3617,0
BarbJanny,BarbJanny,,0,1,1,0,1,1,1,1,1,0,25,0,3618,0
SampaioFredson,SampaioFredson,,0,1,1,0,1,1,1,1,1,0,25,0,3619,0
CaptoteroFabio,CaptoteroFabio,,0,1,1,0,1,1,1,1,1,0,25,0,3620,0
About_Di,About_Di,,0,1,1,0,1,1,1,1,1,0,25,0,3621,0
mariasansone161,mariasansone161,,0,1,1,0,1,1,1,1,1,0,25,0,3622,0
MaverickV38,MaverickV38,,0,1,1,0,1,1,1,1,1,0,25,0,3623,0
lucianaleandrol,lucianaleandrol,,0,1,1,0,1,1,1,1,1,0,25,0,3624,0
david3john,david3john,,0,1,1,0,1,1,1,1,1,0,25,0,3625,0
mineto41,mineto41,,0,1,1,0,1,1,1,1,1,0,25,0,3626,0
mcasimoes57,mcasimoes57,,0,1,1,0,1,1,1,1,1,0,25,0,3627,0
helenagsoo,helenagsoo,,0,1,1,0,1,1,1,1,1,0,25,0,3628,0
PrincessGyn,PrincessGyn,,0,1,1,0,1,1,1,1,1,0,25,0,3629,0
Roger88556715,Roger88556715,,0,1,1,0,1,1,1,1,1,0,25,0,3630,0
denislcarvalho,denislcarvalho,,0,2,2,0,2,2,1,1,1,0,25,0,3631,0
lobomai,lobomai,,0,1,1,0,1,1,1,1,1,0,25,0,3632,0
SandraPFNasc,SandraPFNasc,,0,1,1,0,1,1,1,1,1,0,25,0,3633,0
rtbernardino1,rtbernardino1,,0,1,1,0,1,1,1,1,1,0,25,0,3634,0
susin_l,susin_l,,0,1,1,0,1,1,1,1,1,0,25,0,3635,0
hebert_ferro,hebert_ferro,,0,1,1,0,1,1,1,1,1,0,25,0,3636,0
solangegoesmot1,solangegoesmot1,,0,1,1,0,1,1,1,1,1,0,25,0,3637,0
Joabemborges,Joabemborges,,0,1,1,0,1,1,1,1,1,0,25,0,3638,0
nathbarbosa86,nathbarbosa86,,0,1,1,0,1,1,1,1,1,0,25,0,3639,0
ElianeZerati,ElianeZerati,,0,1,1,0,1,1,1,1,1,0,25,0,3640,0
PatyLobato5,PatyLobato5,,0,1,1,0,1,1,1,1,1,0,25,0,3641,0
FatahaBhukha,FatahaBhukha,,0,1,1,0,1,1,1,1,1,0,25,0,3642,0
jacksonnfilho,jacksonnfilho,,0,1,1,0,1,1,1,1,1,0,25,0,3643,0
B4lVOa18c8WF7ks,B4lVOa18c8WF7ks,,0,1,1,0,1,1,1,1,1,0,25,0,3644,0
g_garc2,g_garc2,,0,1,1,0,1,1,1,1,1,0,25,0,3645,0
Ordemprogresso7,Ordemprogresso7,,0,1,1,0,1,1,1,1,1,0,25,0,3646,0
Setnof3,Setnof3,,0,1,1,0,1,1,1,1,1,0,25,0,3647,0
ress22_teresina,ress22_teresina,,0,1,1,0,1,1,1,1,1,0,25,0,3648,0
SilvaMarcosrj,SilvaMarcosrj,,0,1,1,0,1,1,1,1,1,0,25,0,3649,0
onconaras,onconaras,,0,1,1,0,1,1,1,1,1,0,25,0,3650,0
HAROLDOEVANGELI,HAROLDOEVANGELI,,0,1,1,0,1,1,1,1,1,0,25,0,3651,0
TomLima777,TomLima777,,0,1,1,0,1,1,1,1,1,0,25,0,3652,0
HughHonorato,HughHonorato,,0,1,1,0,1,1,1,1,1,0,25,0,3653,0
MrcioMagalhaes,MrcioMagalhaes,,0,1,1,0,1,1,1,1,1,0,25,0,3654,0
Douglas_1511,Douglas_1511,,0,1,1,0,1,1,1,1,1,0,25,0,3655,0
CassioAPJ,CassioAPJ,,0,1,1,0,1,1,1,1,1,0,25,0,3656,0
SergioMitsuoSJC,SergioMitsuoSJC,,0,1,1,0,1,1,1,1,1,0,25,0,3657,0
CatiaElousia,CatiaElousia,,0,1,1,0,1,1,1,1,1,0,25,0,3658,0
deivid_lembeck,deivid_lembeck,,0,1,1,0,1,1,1,1,1,0,25,0,3659,0
LidiWRE,LidiWRE,,0,1,1,0,1,1,1,1,1,0,25,0,3660,0
MarciaP_RJ,MarciaP_RJ,,0,1,1,0,1,1,1,1,1,0,25,0,3661,0
B22Syrena,B22Syrena,,0,1,1,0,1,1,1,1,1,0,25,0,3662,0
mitags,mitags,,0,1,1,0,1,1,1,1,1,0,25,0,3663,0
Mich_Arcangeli,Mich_Arcangeli,,0,1,1,0,1,1,1,1,1,0,25,0,3664,0
Chris_80F,Chris_80F,,0,1,1,0,1,1,1,1,1,0,25,0,3665,0
cleber_rodf,cleber_rodf,,0,1,1,0,1,1,1,1,1,0,25,0,3666,0
FCG57782889,FCG57782889,,0,1,1,0,1,1,1,1,1,0,25,0,3667,0
DolivaGerson,DolivaGerson,,0,1,1,0,1,1,1,1,1,0,25,0,3668,0
macmachado57,macmachado57,,0,1,1,0,1,1,1,1,1,0,25,0,3669,0
sheilagertrudes,sheilagertrudes,,0,1,1,0,1,1,1,1,1,0,25,0,3670,0
coito_cristina,coito_cristina,,0,1,1,0,1,1,1,1,1,0,25,0,3671,0
MijaroNakombi,MijaroNakombi,,0,1,1,0,1,1,1,1,1,0,25,0,3672,0
AP3009,AP3009,,0,1,1,0,1,1,1,1,1,0,25,0,3673,0
paulomaiorano,paulomaiorano,,0,1,1,0,1,1,1,1,1,0,25,0,3674,0
Josbrsousa,Josbrsousa,,0,1,1,0,1,1,1,1,1,0,25,0,3675,0
EspinosaCrsiete,EspinosaCrsiete,,0,1,1,0,1,1,1,1,1,0,237,195,3677,0
valenciacf,valenciacf,,1,0,1,1,0,1,0,0,0,0,237,195,3676,0
Jpigozzi,Jpigozzi,,0,1,1,0,1,1,1,1,1,0,25,0,3678,0
CristianDequi,CristianDequi,,0,1,1,0,1,1,1,1,1,0,25,0,3679,0
Liviofelix,Liviofelix,,0,1,1,0,1,1,1,1,1,0,25,0,3680,0
Marinet83294755,Marinet83294755,,0,1,1,0,1,1,1,1,1,0,25,0,3681,0
AAmaracaja,AAmaracaja,,0,1,1,0,1,1,1,1,1,0,25,0,3682,0
tato_rj,tato_rj,,0,1,1,0,1,1,1,1,1,0,25,0,3683,0
nagbarros,nagbarros,,0,1,1,0,1,1,1,1,1,0,25,0,3684,0
zonariflavia,zonariflavia,,0,2,2,0,2,2,1,1,1,0,25,0,3685,0
franssinete,franssinete,,0,1,1,0,1,1,1,1,1,0,238,196,3687,0
Alepa_com,Alepa_com,,1,0,1,1,0,1,0,0,0,0,238,196,3686,0
GILSantana1080,GILSantana1080,,0,1,1,0,1,1,1,1,1,0,125,0,3688,0
vicatugy,vicatugy,,0,1,1,0,1,1,1,1,1,0,55,0,3689,0
franceaubresil,franceaubresil,,7,0,7,7,0,7,0,0,0,0,76,0,1568,0
BrigitteSCollet,BrigitteSCollet,,0,1,1,0,1,1,1,1,1,0,76,0,3690,0
Mah31Santiago,Mah31Santiago,,0,1,1,0,1,1,1,1,1,0,213,0,3691,0
fabioirodrigues,fabioirodrigues,,95,0,95,95,0,95,0,0,0,0,213,0,76,0
carloslimaalves,carloslimaalves,,0,1,1,0,1,1,1,1,1,0,239,197,3693,0
INFARMED_IP,INFARMED_IP,,1,0,1,1,0,1,0,0,0,0,239,197,3692,0
teixeira_cica,teixeira_cica,,0,1,1,0,1,1,1,1,1,0,19,0,3694,0
marfcg,marfcg,,87,0,87,88,0,88,0,0,0,0,19,0,64,0.001203
micolin,micolin,,0,1,1,0,1,1,1,1,1,0,213,0,3695,0
ana_celiacosta,ana_celiacosta,,0,1,1,0,1,1,1,1,1,0,76,0,3696,0
SiSantos_,SiSantos_,,0,1,1,0,1,1,1,1,1,0,213,0,3697,0
glossepgurl,glossepgurl,,0,1,1,0,2,2,2,0.571429,0.625,0,5,0,3698,0
DANTEPHDD,DANTEPHDD,,0,2,2,0,2,2,1,1,1,0,88,0,3699,0
alexcarmo72,alexcarmo72,,0,1,1,0,1,1,1,1,1,0,76,0,3700,0
littlwchaery,littlwchaery,,0,1,1,0,1,1,2,0.571429,0.625,0,5,0,3701,0
M4ri1914,M4ri1914,,0,1,1,0,1,1,1,1,1,0,213,0,3702,0
vhsampaio,vhsampaio,,0,1,1,0,1,1,2,0.545455,0.583333,0,10,0,3703,0
MariRMF,MariRMF,,0,1,1,0,1,1,2,0.545455,0.583333,0,10,0,3704,0
Marcionin,Marcionin,,0,1,1,0,2,2,2,0.545455,0.583333,0,10,0,3705,0
antoniobacellar,antoniobacellar,,0,1,1,0,1,1,2,0.545455,0.583333,0,10,0,3706,0
Bertrand_allen2,Bertrand_allen2,,0,1,1,0,1,1,1,1,1,0,19,0,3707,0
JTAH_1990,JTAH_1990,,1,1,2,1,1,2,0,0,0,0,240,198,3708,0
MarcelaDamasc11,MarcelaDamasc11,,0,1,1,0,1,1,1,1,1,0,213,0,3709,0
claudioandre_,claudioandre_,,0,1,1,0,1,1,1,1,1,0,241,199,3711,0
revistapiaui,revistapiaui,,1,0,1,1,0,1,0,0,0,0,241,199,3710,0
douglas_cosfag,douglas_cosfag,,1,0,1,1,0,1,0,0,0,0,0,0,112,0
eudesimoes,eudesimoes,,0,1,1,0,1,1,1,1,1,0,19,0,3712,0
omartgbl34,omartgbl34,,0,1,1,0,1,1,1,1,1,0,19,0,3713,0
melmarkoski,melmarkoski,,0,1,1,0,1,1,1,1,1,0,19,0,3714,0
mvankerkhove,mvankerkhove,,4,0,4,4,0,4,0,0,0,0,31,0,120,0.25
cidadgm1,cidadgm1,,0,1,1,0,1,1,1,1,1,0,25,0,3715,0
lincolnwa,lincolnwa,,0,1,1,0,1,1,1,1,1,0,19,0,3716,0
isa_honeyice,isa_honeyice,,0,1,1,0,1,1,1,1,1,0,242,200,3718,0
Laricita3,Laricita3,,1,0,1,1,0,1,0,0,0,0,242,200,3717,0
DoRetuit,DoRetuit,,0,1,1,0,1,1,1,1,1,0,243,201,3720,0
LeichsenringC,LeichsenringC,,1,0,1,1,0,1,0,0,0,0,243,201,3719,0
AnaLuci43578997,AnaLuci43578997,,0,1,1,0,1,1,1,1,1,0,19,0,3721,0
rafaelmeneses93,rafaelmeneses93,,0,1,1,0,1,1,1,1,1,0,19,0,3722,0
mrm672xx,mrm672xx,,0,2,2,0,2,2,1,1,1,0,76,0,3723,1
MagnaniClarissa,MagnaniClarissa,,0,1,1,0,1,1,1,1,1,0,213,0,3724,0
lucio_fogazzi,lucio_fogazzi,,0,1,1,0,1,1,1,1,1,0,0,0,3725,0
davillanunesl,davillanunesl,,0,1,1,0,1,1,2,0.545455,0.583333,0,10,0,3726,0
aline_xD,aline_xD,,0,1,1,0,1,1,1,1,1,0,213,0,3727,0
jlfleite,jlfleite,,0,1,1,0,1,1,1,1,1,0,19,0,3728,0
AnaCunh62077053,AnaCunh62077053,,0,1,1,0,1,1,1,1,1,0,213,0,3729,0
donnabaratex,donnabaratex,,0,1,1,0,1,1,1,1,1,0,213,0,3730,0
bobclaye,bobclaye,,0,1,1,0,1,1,1,1,1,0,19,0,3731,0
zurenemanique,zurenemanique,,0,2,2,0,2,2,1,1,1,0,19,0,3733,0
wilsorodrigues,wilsorodrigues,,0,1,1,0,1,1,1,1,1,0,19,0,3734,0
monicabergamo,monicabergamo,,0,1,1,0,1,1,1,1,1,0,19,0,3735,0
josianemaieski,josianemaieski,,0,1,1,0,1,1,1,1,1,0,213,0,3736,0
aperteoalt,aperteoalt,,0,1,1,0,1,1,2,0.545455,0.583333,0,10,0,3737,0
djalepeixoto,djalepeixoto,,0,1,1,0,1,1,1,1,1,0,213,0,3738,0
padilhajr88,padilhajr88,,0,1,1,0,1,1,1,1,1,0,225,184,3739,0
Claudiaped2,Claudiaped2,,0,2,2,0,2,2,1,1,1,0,76,0,3740,1
Paulinho2pac,Paulinho2pac,,0,1,1,0,1,1,1,1,1,0,213,0,3741,0
gomes_coe,gomes_coe,,0,1,1,0,1,1,1,1,1,0,213,0,3742,0
jroberto6452,jroberto6452,,0,3,3,0,4,4,1,1,1,0,38,0,3745,0
Caixa,Caixa,,1,0,1,2,0,2,0,0,0,0,38,0,3744,0
VivianSa13,VivianSa13,,1,0,1,1,0,1,0,0,0,0,38,0,3743,0
robertogomes13,robertogomes13,,0,1,1,0,1,1,1,1,1,0,19,0,3746,0
LuizianneLinsPT,LuizianneLinsPT,,3,0,3,3,0,3,0,0,0,0,19,0,3732,0
julievr2009,julievr2009,,0,1,1,0,1,1,1,1,1,0,213,0,3747,0
BentoPeixoto2,BentoPeixoto2,,0,2,2,0,2,2,1,1,1,0,45,0,3749,0
lula,lula,,1,0,1,1,0,1,0,0,0,0,45,0,3748,0
barrgui19,barrgui19,,0,2,2,0,2,2,1,1,1,0,19,0,3750,0
JoseHugoHonora2,JoseHugoHonora2,,0,1,1,0,1,1,1,1,1,0,4,0,3751,0
Finep,Finep,,3,0,3,3,0,3,0,0,0,0,4,0,323,0.166667
SosoGarbin,SosoGarbin,,0,1,1,0,1,1,1,1,1,0,213,0,3752,0
Anselmo_C_Paiva,Anselmo_C_Paiva,,0,1,1,0,1,1,1,1,1,0,244,202,3754,0
Agencia_Tambor,Agencia_Tambor,,2,0,2,2,0,2,0,0,0,0,244,202,3753,0
anasizenando,anasizenando,,1,0,1,1,0,1,0,0,0,0,80,0,1225,0
Dils_santos,Dils_santos,,1,0,1,1,0,1,0,0,0,0,0,0,111,0
JamesFricke19,JamesFricke19,,0,1,1,0,1,1,1,1,1,0,213,0,3755,0
deaneterra_,deaneterra_,,0,1,1,0,1,1,2,0.545455,0.583333,0,10,0,3756,0
akelamulher,akelamulher,,0,1,1,0,1,1,1,1,1,0,213,0,3757,0
Dotorabr,Dotorabr,,0,1,1,0,1,1,1,1,1,0,213,0,3758,0
chega_cansada,chega_cansada,,0,1,1,0,1,1,1,1,1,0,213,0,3759,0
laricotanovaes,laricotanovaes,,0,1,1,0,1,1,1,1,1,0,213,0,3760,0
edblogue,edblogue,,0,1,1,0,1,1,1,1,1,0,244,202,3761,0
davysales,davysales,,0,2,2,0,3,3,1,1,1,0,88,0,3762,0
perprecta,perprecta,,0,1,1,0,1,1,1,1,1,0,213,0,3763,0
jfbezerra2,jfbezerra2,,0,3,3,0,3,3,1,1,1,0,19,0,3764,0.333333
azavascki,azavascki,,0,1,1,0,1,1,1,1,1,0,19,0,3765,0
MarKubik,MarKubik,,0,1,1,0,1,1,1,1,1,0,213,0,3766,0
Pretinha_crazy,Pretinha_crazy,,0,1,1,0,1,1,1,1,1,0,213,0,3767,0
URSULABATISTA,URSULABATISTA,,0,1,1,0,1,1,1,1,1,0,88,0,3768,0
LucasCGarcez1,LucasCGarcez1,,0,1,1,0,1,1,1,1,1,0,213,0,3769,0
daniimedusaa,daniimedusaa,,0,1,1,0,1,1,1,1,1,0,213,0,3770,0
carlosalmo,carlosalmo,,0,1,1,0,1,1,1,1,1,0,213,0,3771,0
pinpinmeuamor,pinpinmeuamor,,0,1,1,0,1,1,1,1,1,0,213,0,3772,0
arturleon_,arturleon_,,0,1,1,0,1,1,1,1,1,0,213,0,3773,0
analicet25,analicet25,,0,1,1,0,1,1,1,1,1,0,213,0,3774,0
LARAo_0,LARAo_0,,0,2,2,0,3,3,2,0.583333,0.642857,0,10,0,3775,0
BrasEliana,BrasEliana,,0,1,1,0,1,1,1,1,1,0,213,0,3776,0
alecosta36,alecosta36,,0,1,1,0,1,1,1,1,1,0,213,0,3777,0
AndersonBrito_,AndersonBrito_,,0,1,1,0,1,1,1,1,1,0,19,0,3778,0
letitbeana,letitbeana,,0,1,1,0,1,1,1,1,1,0,213,0,3779,0
tparanhos,tparanhos,,0,1,1,0,1,1,1,1,1,0,213,0,3780,0
YE0N1TY,YE0N1TY,,0,1,1,0,1,1,1,1,1,0,245,203,3782,0
jiminsbybaby,jiminsbybaby,,1,0,1,1,0,1,0,0,0,0,245,203,3781,0
anafs_rep_fr,anafs_rep_fr,,0,1,1,0,1,1,2,0.6,0.666667,0,31,0,3783,0
josegallucci,josegallucci,,0,3,3,0,3,3,1,1,1,0,19,0,3784,0
guipmello,guipmello,,0,1,1,0,1,1,1,1,1,0,5,0,3785,0
Barrazine,Barrazine,,0,1,1,0,1,1,1,1,1,0,5,0,3786,0
MauricioPontes,MauricioPontes,,0,1,1,0,1,1,1,1,1,0,19,0,3787,0
f5online_,f5online_,,3,0,3,3,0,3,0,0,0,0,147,0,177,0.333333
correfrotinha,correfrotinha,,0,1,1,0,1,1,1,1,1,0,19,0,3788,0
andreamb,andreamb,,0,1,1,0,1,1,1,1,1,0,19,0,3789,0
MCrisLemos,MCrisLemos,,0,1,1,0,1,1,1,1,1,0,19,0,3790,0
b_ishigami,b_ishigami,,0,1,1,0,1,1,1,1,1,0,19,0,3791,0
Fraan_Moreiraa_,Fraan_Moreiraa_,,0,1,1,0,1,1,1,1,1,0,19,0,3792,0
Everton_Luis,Everton_Luis,,0,1,1,0,1,1,1,1,1,0,19,0,3793,0
marisonl,marisonl,,0,1,1,0,1,1,1,1,1,0,19,0,3794,0
alanie,alanie,,0,1,1,0,1,1,1,1,1,0,19,0,3795,0
perminio1,perminio1,,0,1,1,0,1,1,1,1,1,0,19,0,3796,0
PauloAmoretty,PauloAmoretty,,0,2,2,0,2,2,1,1,1,0,76,0,3797,1
mellziland,mellziland,,0,1,1,0,1,1,1,1,1,0,19,0,3798,0
Comprova,Comprova,,1,1,2,1,1,2,1,1,1,0,0,0,227,0
LFernando75,LFernando75,,0,2,2,0,2,2,1,1,1,0,4,0,3799,0
pmbrusque,pmbrusque,,1,0,1,1,0,1,0,0,0,0,0,0,110,0
jujusilveirass,jujusilveirass,,0,1,1,0,1,1,1,1,1,0,88,0,3800,0
jaspionik,jaspionik,,0,1,1,0,1,1,2,0.666667,0.75,0,4,0,3801,0
LabcidadeFAUUSP,LabcidadeFAUUSP,,8,0,8,8,0,8,0,0,0,0,43,0,330,0
paulafsantoro,paulafsantoro,,0,1,1,0,1,1,1,1,1,0,43,0,3802,0
Timao_p_Sempre,Timao_p_Sempre,,0,1,1,0,1,1,2,0.571429,0.625,0,5,0,3803,0
anamonicabb,anamonicabb,,0,1,1,0,1,1,1,1,1,0,88,0,3804,0
cassialorenatei,cassialorenatei,,1,0,1,1,0,1,0,0,0,0,10,0,329,0
paulacarvalho,paulacarvalho,,1,0,1,2,0,2,0,0,0,0,45,0,195,0
bcs19764,bcs19764,,0,2,2,0,2,2,2,0.6,0.666667,0,10,0,3805,0.5
C_Anonymous396,C_Anonymous396,,0,1,1,0,1,1,1,1,1,0,246,204,3807,0
CeceCecespuffs,CeceCecespuffs,,1,0,1,1,0,1,0,0,0,0,246,204,3806,0
DulceHelenaMen2,DulceHelenaMen2,,0,2,2,0,2,2,1,1,1,0,76,0,3808,1
samusaraiva,samusaraiva,,0,1,1,0,1,1,1,1,1,0,25,0,3809,0
CyRafaelamarani,CyRafaelamarani,,1,1,2,1,1,2,0,0,0,0,247,205,3810,0
m_f_vieira,m_f_vieira,,0,1,1,0,1,1,2,0.545455,0.583333,0,10,0,3811,0
kassioaranha,kassioaranha,,0,2,2,0,2,2,1,1,1,0,19,0,3812,0
cahbuzelim,cahbuzelim,,0,2,2,0,2,2,1,1,1,0,19,0,3813,0
MarildeTeixeira,MarildeTeixeira,,0,1,1,0,1,1,1,1,1,0,88,0,3814,0
cacadoresdobem,cacadoresdobem,,0,1,1,0,1,1,1,1,1,0,27,0,3815,0
CE_PTrep,CE_PTrep,,3,0,3,3,0,3,0,0,0,0,10,0,328,0
mugeiro_daniel,mugeiro_daniel,,0,1,1,0,1,1,1,1,1,0,10,0,3816,0
JaGusmao,JaGusmao,,0,6,6,0,6,6,2,0.714286,0.8,0,0,0,3818,0.033333
viva_economia,viva_economia,,0,1,1,0,1,1,1,1,1,0,10,0,3819,0
A_Chieppe,A_Chieppe,,3,0,3,3,0,3,0,0,0,0,0,0,108,0.333333
apnegrao,apnegrao,,0,1,1,0,1,1,2,0.545455,0.583333,0,10,0,3820,0
mdmarcosgeraldo,mdmarcosgeraldo,,0,1,1,0,1,1,1,1,1,0,25,0,3821,0
tourmorrow_uneb,tourmorrow_uneb,,1,0,1,1,0,1,0,0,0,0,0,0,3817,0
Relevante_,Relevante_,,0,1,1,0,1,1,1,1,1,0,25,0,3822,0
ScarletA546,ScarletA546,,2,0,2,3,0,3,0,0,0,0,20,0,385,1
itallothyago,itallothyago,,0,1,1,0,1,1,1,1,1,0,248,206,3824,0
AlexTrezAs,AlexTrezAs,,1,0,1,1,0,1,0,0,0,0,248,206,3823,0
Carlosgrupon8,Carlosgrupon8,,0,1,1,0,1,1,1,1,1,0,19,0,3825,0
silvestremarcio,silvestremarcio,,0,1,1,0,1,1,2,0.545455,0.583333,0,10,0,3826,0
SesiSaoPaulo,SesiSaoPaulo,,0,1,1,0,1,1,1,1,1,0,249,207,3828,0
CCulturalFiesp,CCulturalFiesp,,1,0,1,1,0,1,0,0,0,0,249,207,3827,0
rodrigues_borja,rodrigues_borja,,0,2,2,0,2,2,2,0.6,0.666667,0,10,0,3829,0.5
Sueli28677296,Sueli28677296,,0,1,1,0,1,1,2,0.545455,0.583333,0,10,0,3830,0
AdilsonFerrari6,AdilsonFerrari6,,0,2,2,0,2,2,3,0.521739,0.569444,0,4,0,3831,1
PhoenixLioness7,PhoenixLioness7,,0,2,2,0,2,2,3,0.521739,0.569444,0,4,0,3832,1
Rosacristina952,Rosacristina952,,0,1,1,0,1,1,2,0.666667,0.75,0,4,0,3833,0
Tmrlopes0234,Tmrlopes0234,,0,2,2,0,2,2,2,0.6,0.666667,0,10,0,3834,0.5
Mmacedo_tweets,Mmacedo_tweets,,1,0,1,3,0,3,0,0,0,0,20,0,384,0
deABREU,deABREU,,0,2,2,0,2,2,1,1,1,0,19,0,3835,0
DataLagom,DataLagom,,0,2,2,0,2,2,1,1,1,0,19,0,3836,0
Alvesvp4,Alvesvp4,,0,1,1,0,1,1,1,1,1,0,38,0,3837,0
pensarinfog,pensarinfog,,0,1,1,0,1,1,1,1,1,0,250,208,3839,0
LabVis_UFRJ,LabVis_UFRJ,,2,0,2,2,0,2,0,0,0,0,250,208,3838,0
lenhagui,lenhagui,,0,1,1,0,1,1,1,1,1,0,251,209,3841,0
erikrs11,erikrs11,,1,0,1,1,0,1,0,0,0,0,251,209,3840,0
KarlaVa32508121,KarlaVa32508121,,0,1,1,0,1,1,1,1,1,0,88,0,3842,0
zezepr,zezepr,,0,2,2,0,2,2,2,0.6,0.666667,0,10,0,3843,0.5
JairS,JairS,,0,1,1,0,1,1,1,1,1,0,88,0,3844,0
CarlaoBot,CarlaoBot,,0,2,2,0,2,2,2,0.75,0.833333,0,45,0,3846,0
malupedroso,malupedroso,,0,2,2,0,2,2,2,0.6,0.666667,0,10,0,3847,0.5
eraser,eraser,,1,0,1,1,0,1,0,0,0,0,45,0,3845,0
AlexMonteiro93,AlexMonteiro93,,0,1,1,0,1,1,1,1,1,0,43,0,3848,0
Claudia29142294,Claudia29142294,,0,2,2,0,2,2,2,0.6,0.666667,0,10,0,3849,0.5
alinadpc1,alinadpc1,,0,3,3,0,3,3,2,0.636364,0.714286,0,10,0,3850,0.166667
BarbosaOrlandy,BarbosaOrlandy,,0,1,1,0,1,1,2,0.666667,0.75,0,4,0,3851,0
jamersontiossi,jamersontiossi,,0,1,1,0,1,1,1,1,1,0,5,0,3852,0
lillian_romao,lillian_romao,,0,1,1,0,1,1,2,0.545455,0.583333,0,10,0,3853,0
OurBloggingLife,OurBloggingLife,,0,1,1,0,1,1,1,1,1,0,0,0,3854,0
OM_SRC,OM_SRC,,1,0,1,1,0,1,0,0,0,0,31,0,271,0
DoloresGuedes1,DoloresGuedes1,,0,1,1,0,1,1,2,0.666667,0.75,0,4,0,3855,0
kaschube3,kaschube3,,0,1,1,0,1,1,1,1,1,0,0,0,3856,0
4globalbenefit,4globalbenefit,,0,2,2,0,2,2,2,0.75,0.833333,0,31,0,3857,0.5
CDinOT,CDinOT,,5,0,5,5,0,5,0,0,0,0,166,126,2293,0.2
luiggi_dantas,luiggi_dantas,,0,2,2,0,2,2,1,1,1,0,19,0,3858,0
Avilasch1,Avilasch1,,0,1,1,0,1,1,2,0.545455,0.583333,0,10,0,3859,0
GabiNeumann95,GabiNeumann95,,0,2,2,0,2,2,1,1,1,0,76,0,3860,1
jsscs81,jsscs81,,0,1,1,0,1,1,1,1,1,0,88,0,3861,0
SaraAlm46462303,SaraAlm46462303,,0,1,1,0,1,1,1,1,1,0,8,0,3862,0
interenfusp,interenfusp,,0,1,1,0,2,2,2,0.571429,0.625,0,5,0,3863,0
hornurias,hornurias,,0,2,2,0,2,2,1,1,1,0,76,0,3864,1
MarciaTaveira,MarciaTaveira,,0,1,1,0,1,1,1,1,1,0,76,0,3865,0
MaricaPref,MaricaPref,,2,0,2,2,0,2,0,0,0,0,76,0,2279,0
ManoelDaCostaI1,ManoelDaCostaI1,,0,1,1,0,1,1,1,1,1,0,88,0,3866,0
bittersteel01,bittersteel01,,0,2,2,0,2,2,1,1,1,0,19,0,3867,0
juliagiannella,juliagiannella,,0,1,1,0,1,1,1,1,1,0,250,208,3868,0
Elektronz,Elektronz,,0,1,1,0,1,1,2,0.6,0.666667,0,31,0,3869,0
estenioelbainy,estenioelbainy,,0,1,1,0,1,1,2,0.6,0.666667,0,31,0,3870,0
Mariade22366064,Mariade22366064,,0,2,2,0,2,2,1,1,1,0,4,0,3871,0.5
ed_alameda,ed_alameda,,0,1,1,0,1,1,2,0.6,0.666667,0,31,0,3872,0
tinojunior,tinojunior,,1,0,1,1,0,1,0,0,0,0,170,130,2346,0
LeaMarciaSilva,LeaMarciaSilva,,0,2,2,0,2,2,2,0.6,0.666667,0,10,0,3873,0.5
lferrasi,lferrasi,,0,1,1,0,1,1,1,1,1,0,19,0,3874,0
sds_unb,sds_unb,,0,1,1,0,1,1,1,1,1,0,31,0,3875,0
_mdeMagnifica,_mdeMagnifica,,0,2,2,0,2,2,1,1,1,0,76,0,3876,1
O_ConselheiroBR,O_ConselheiroBR,,0,2,2,0,2,2,1,1,1,0,28,0,3877,0.5
Engenheirorn,Engenheirorn,,0,1,1,0,1,1,1,1,1,0,4,0,3878,0
ABRABARPR,ABRABARPR,,0,1,1,0,1,1,3,0.413793,0.458333,0,4,0,3879,0
MTurismo,MTurismo,,0,1,1,0,1,1,3,0.413793,0.458333,0,4,0,3880,0
tefstepho,tefstepho,,0,1,1,0,1,1,1,1,1,0,38,0,3881,0
JovemPanEntrete,JovemPanEntrete,,1,0,1,2,0,2,0,0,0,0,45,0,194,0
viniciusmourajp,viniciusmourajp,,1,0,1,1,0,1,0,0,0,0,45,0,193,0
ibaztx,ibaztx,,0,1,1,0,1,1,1,1,1,0,88,0,3882,0
zoemartinez_05,zoemartinez_05,,1,0,1,1,0,1,0,0,0,0,45,0,192,0
fabifbbr,fabifbbr,,1,0,1,2,0,2,0,0,0,0,45,0,191,0
JovemPanNews,JovemPanNews,,1,0,1,2,0,2,0,0,0,0,45,0,190,0
paulomathias,paulomathias,,1,0,1,1,0,1,0,0,0,0,45,0,189,0
leofoletto,leofoletto,,0,1,1,0,1,1,1,1,1,0,43,0,3883,0
xunguangyue1,xunguangyue1,,0,1,1,0,1,1,1,1,1,0,252,210,3885,0
XHportugues,XHportugues,,1,0,1,1,0,1,0,0,0,0,252,210,3884,0
joaozinreidela,joaozinreidela,,0,1,1,0,1,1,1,1,1,0,253,211,3887,0
jaohelder,jaohelder,,1,0,1,1,0,1,0,0,0,0,253,211,3886,0
arocamacho,arocamacho,,0,1,1,0,1,1,1,1,1,0,43,0,3888,0
LiviaSacchetto,LiviaSacchetto,,0,2,2,0,2,2,2,0.75,0.833333,0,76,0,3889,1
eduardo_ficial,eduardo_ficial,,0,1,1,0,1,1,1,1,1,0,0,0,3890,0
FusaroZila,FusaroZila,,0,1,1,0,1,1,1,1,1,0,50,0,3891,0
mobilidadeurb,mobilidadeurb,,0,1,1,0,1,1,1,1,1,0,43,0,3892,0
RicardoOBarbos1,RicardoOBarbos1,,0,1,1,0,2,2,1,1,1,0,50,0,3893,0
araujocida_,araujocida_,,0,1,1,0,1,1,1,1,1,0,213,0,3894,0
PedroLi41542560,PedroLi41542560,,0,1,1,0,1,1,1,1,1,0,254,212,3896,0
CiaDocasBa,CiaDocasBa,,1,0,1,1,0,1,0,0,0,0,254,212,3895,0
raquelrolnik,raquelrolnik,,0,1,1,0,1,1,1,1,1,0,43,0,3897,0
KleberRibeiroC3,KleberRibeiroC3,,0,2,2,0,2,2,1,1,1,0,76,0,3898,1
abatefilho_rafa,abatefilho_rafa,,0,1,1,0,1,1,1,1,1,0,50,0,3899,0
Barbara08811524,Barbara08811524,,0,1,1,0,1,1,2,0.545455,0.583333,0,10,0,3900,0
lauraReedus1,lauraReedus1,,0,1,1,0,1,1,1,1,1,0,29,0,3901,0
patrickfranca,patrickfranca,,0,3,3,0,3,3,1,1,1,0,19,0,3902,0
suzanalage,suzanalage,,0,1,1,0,1,1,2,0.545455,0.583333,0,10,0,3903,0
lfascencao,lfascencao,,0,1,1,0,1,1,1,1,1,0,50,0,3904,0
arciliopg,arciliopg,,0,1,1,0,1,1,1,1,1,0,88,0,3905,0
DiegoHA_oficial,DiegoHA_oficial,,1,0,1,1,0,1,0,0,0,0,14,10,526,0
Pamelajeferson1,Pamelajeferson1,,0,2,2,0,2,2,1,1,1,0,50,0,3906,0
CaP21B,CaP21B,,0,1,1,0,1,1,1,1,1,0,50,0,3907,0
irenilda_nunes,irenilda_nunes,,0,3,3,0,3,3,1,1,1,0,45,0,3908,0.166667
sissanieves_,sissanieves_,,0,1,1,0,1,1,1,1,1,0,255,213,3910,0
InclusaoSP,InclusaoSP,,1,0,1,1,0,1,0,0,0,0,255,213,3909,0
lara_mesquita,lara_mesquita,,0,2,2,0,2,2,1,1,1,0,256,214,3913,0.5
fgv_clear,fgv_clear,,1,1,2,1,1,2,1,1,1,0,256,214,3912,0.5
tweet_afrea,tweet_afrea,,2,0,2,2,0,2,0,0,0,0,256,214,3911,0.5
jotahsilva,jotahsilva,,0,2,2,0,2,2,2,0.583333,0.642857,0,88,0,3914,0
araujoraposogm1,araujoraposogm1,,0,3,3,0,3,3,1,1,1,0,8,0,3915,0.333333
ibepacse,ibepacse,,0,2,2,0,2,2,1,1,1,0,257,215,3918,0
JotaInfo,JotaInfo,,1,0,1,1,0,1,0,0,0,0,257,215,3917,0
lbarroso,lbarroso,,1,0,1,1,0,1,0,0,0,0,257,215,3916,0
ReginaldoFiloso,ReginaldoFiloso,,0,1,1,0,1,1,1,1,1,0,88,0,3919,0
FE_LOPESRIBEIRO,FE_LOPESRIBEIRO,,0,2,2,0,2,2,2,0.666667,0.75,0,88,0,3920,0
PoliticaTri,PoliticaTri,,0,1,1,0,1,1,1,1,1,0,88,0,3921,0
Leilahgarcia,Leilahgarcia,,0,1,1,0,1,1,1,1,1,0,88,0,3922,0
JornalGGN,JornalGGN,,2,0,2,2,0,2,0,0,0,0,0,0,105,0.5
alexnacto,alexnacto,,0,1,1,0,1,1,2,0.666667,0.75,0,0,0,3923,0
BLOGdoPEPE,BLOGdoPEPE,,0,1,1,0,2,2,1,1,1,0,88,0,3924,0
silveira_jp,silveira_jp,,0,2,2,0,2,2,2,0.6,0.666667,0,10,0,3925,0.5
RamiroAparecida,RamiroAparecida,,0,1,1,0,1,1,1,1,1,0,88,0,3926,0
carolparanoia,carolparanoia,,0,1,1,0,1,1,1,1,1,0,88,0,3927,0
CCambara2,CCambara2,,0,1,1,0,1,1,1,1,1,0,88,0,3928,0
AiltonBarcelos3,AiltonBarcelos3,,0,1,1,0,1,1,1,1,1,0,25,0,3929,0
verathaddeu,verathaddeu,,0,1,1,0,2,2,1,1,1,0,25,0,3930,0
sertao_ba,sertao_ba,,0,1,1,0,2,2,1,1,1,0,4,0,3931,0
Naro_Daf,Naro_Daf,,0,1,1,0,1,1,1,1,1,0,25,0,3932,0
Giselebm,Giselebm,,0,1,1,0,1,1,1,1,1,0,27,0,3933,0
eraphs,eraphs,,0,2,2,0,2,2,1,1,1,0,76,0,3934,1
china,china,,1,0,1,1,0,1,0,0,0,0,153,0,2172,0
Miltonneves,Miltonneves,,1,0,1,1,0,1,0,0,0,0,153,0,2171,0
vgintwt,vgintwt,,0,1,1,0,1,1,2,0.571429,0.625,0,5,0,3935,0
DaniGomeesss,DaniGomeesss,,1,2,3,1,2,3,1,1,1,0,258,216,3937,0.5
BinhasOnte,BinhasOnte,,1,0,1,1,0,1,0,0,0,0,258,216,3936,0
mundoalergico,mundoalergico,,1,1,2,1,1,2,0,0,0,0,259,217,3938,0
CaiqueGalindo,CaiqueGalindo,,0,2,2,0,2,2,2,0.583333,0.642857,0,19,0,3939,0
FcoDaviFPeixoto,FcoDaviFPeixoto,,0,2,2,0,2,2,1,1,1,0,76,0,3940,1
AnaGlei06853018,AnaGlei06853018,,0,2,2,0,2,2,2,0.75,0.833333,0,90,57,3941,0.5
lucasrolivei51,lucasrolivei51,,0,1,1,0,1,1,1,1,1,0,10,0,3942,0
ONUHABITATBR,ONUHABITATBR,,2,0,2,2,0,2,0,0,0,0,10,0,326,0
elbpublika01,elbpublika01,,0,1,1,0,1,1,1,1,1,0,260,218,3944,0
BitucaSalim,BitucaSalim,,1,0,1,1,0,1,0,0,0,0,260,218,3943,0
gibranst,gibranst,,0,1,1,0,1,1,1,1,1,0,88,0,3945,0
diraholanda,diraholanda,,0,1,1,0,1,1,1,1,1,0,88,0,3946,0
PauloRanazzi,PauloRanazzi,,0,2,2,0,2,2,1,1,1,0,76,0,3947,1
clodoaldocoimb1,clodoaldocoimb1,,0,2,2,0,2,2,4,0.461538,0.534722,0,4,0,3948,1
botinhao,botinhao,,0,2,2,0,2,2,1,1,1,0,4,0,3949,0.5
CassiaTahan,CassiaTahan,,0,2,2,0,2,2,2,0.6,0.666667,0,10,0,3950,0.5
AquelaLara,AquelaLara,,0,2,2,0,2,2,1,1,1,0,19,0,3951,0
ThiberioOlivei1,ThiberioOlivei1,,0,2,2,0,2,2,2,0.6,0.666667,0,10,0,3952,0.5
freebritneybs,freebritneybs,,0,3,3,0,3,3,2,0.636364,0.714286,0,10,0,3953,0.166667
biacoaa,biacoaa,,0,2,2,0,2,2,2,0.6,0.666667,0,10,0,3954,0.5
LucianaOzelin,LucianaOzelin,,0,2,2,0,2,2,4,0.461538,0.534722,0,4,0,3955,1
alexnunez87,alexnunez87,,0,2,2,0,3,3,1,1,1,0,261,219,3958,0.5
TSXGalicia,TSXGalicia,,7,2,9,13,2,15,1,1,1,0,261,219,3957,0.232143
Xunta,Xunta,,7,0,7,7,0,7,0,0,0,0,261,219,3956,0.142857
CarlosPortoRJ,CarlosPortoRJ,,0,1,1,0,1,1,2,0.545455,0.583333,0,10,0,3959,0
daividfss,daividfss,,2,0,2,2,0,2,0,0,0,0,5,0,320,0
BrujulaGalicia,BrujulaGalicia,,0,2,2,0,3,3,1,1,1,0,261,219,3960,0.5
ArteixoOficial,ArteixoOficial,,0,2,2,0,3,3,1,1,1,0,261,219,3961,0.5
atilalemos10,atilalemos10,,2,1,3,4,2,6,0,0,0,0,0,0,58,0.5
Matheus68663495,Matheus68663495,,0,3,3,0,3,3,4,0.48,0.576389,0,4,0,3962,0.5
PammellaG,PammellaG,,0,1,1,0,1,1,1,1,1,0,88,0,3963,0
frentebrasilpop,frentebrasilpop,,0,1,1,0,1,1,1,1,1,0,88,0,3964,0
AzulaMikele,AzulaMikele,,0,1,1,0,1,1,2,0.571429,0.625,0,5,0,3965,0
MChasci,MChasci,,0,1,1,0,1,1,2,0.545455,0.583333,0,10,0,3966,0
fabiolamazzulli,fabiolamazzulli,,0,1,1,0,1,1,1,1,1,0,25,0,3967,0
gabriellerd5,gabriellerd5,,0,2,2,0,2,2,2,0.583333,0.642857,0,41,0,3968,0
NegreiraC,NegreiraC,,0,2,2,0,3,3,1,1,1,0,261,219,3969,0.5
tohellandbackx,tohellandbackx,,0,2,2,0,2,2,1,1,1,0,76,0,3970,1
roseferro,roseferro,,0,2,2,0,2,2,1,1,1,0,19,0,3971,0
livic751,livic751,,0,1,1,0,2,2,1,1,1,0,262,141,3972,0
Radio_Voz,Radio_Voz,,0,2,2,0,3,3,1,1,1,0,261,219,3973,0.5
O_Kandpalleiro,O_Kandpalleiro,,0,2,2,0,3,3,1,1,1,0,261,219,3974,0.5
Modesto,Modesto,,0,1,1,0,1,1,1,1,1,0,10,0,3975,0
laffurr,laffurr,,0,1,1,0,1,1,2,0.571429,0.625,0,5,0,3976,0
falls356789,falls356789,,0,1,1,0,1,1,2,0.571429,0.625,0,5,0,3977,0
ananias_1979,ananias_1979,,0,1,1,0,1,1,2,0.545455,0.583333,0,10,0,3978,0
RtbMoyses,RtbMoyses,,0,2,2,0,2,2,1,1,1,0,81,50,3979,0
Sandra20598198,Sandra20598198,,0,1,1,0,1,1,1,1,1,0,25,0,3980,0
sbtjornalismo,sbtjornalismo,,0,1,1,0,4,4,1,1,1,0,0,0,3981,0
acao32,acao32,,0,2,2,0,2,2,1,1,1,0,41,0,3982,0
davidbsb1,davidbsb1,,0,2,2,0,2,2,1,1,1,0,76,0,3983,1
ACapaDoPastel,ACapaDoPastel,,0,1,1,0,1,1,2,0.571429,0.625,0,5,0,3984,0
AndreaPorto2021,AndreaPorto2021,,0,1,1,0,1,1,1,1,1,0,263,220,3986,0
andreporci,andreporci,,1,0,1,1,0,1,0,0,0,0,263,220,3985,0
jhoncruzalves,jhoncruzalves,,0,1,1,0,1,1,1,1,1,0,264,221,3988,0
JhonPit08318155,JhonPit08318155,,1,0,1,1,0,1,0,0,0,0,264,221,3987,0
DGEstE,DGEstE,,0,1,1,0,1,1,1,1,1,0,8,0,3989,0
Vic46476119,Vic46476119,,0,1,1,0,1,1,1,1,1,0,25,0,3990,0
AMLO3Proyectos,AMLO3Proyectos,,0,1,1,0,1,1,1,1,1,0,29,0,3991,0
videocomfilm,videocomfilm,,0,1,1,0,1,1,1,1,1,0,29,0,3992,0
diogonah,diogonah,,0,1,1,0,1,1,1,1,1,0,19,0,3993,0
lolis281,lolis281,,0,1,1,0,1,1,1,1,1,0,29,0,3994,0
DonaCoisa1,DonaCoisa1,,0,1,1,0,1,1,1,1,1,0,0,0,3995,0
Marcelinoonline,Marcelinoonline,,0,1,1,0,1,1,1,1,1,0,265,222,3997,0
EmbaixadaEUA,EmbaixadaEUA,,1,0,1,1,0,1,0,0,0,0,265,222,3996,0
ElisaBarboux,ElisaBarboux,,0,2,2,0,2,2,1,1,1,0,19,0,3998,0
ElisabethDes,ElisabethDes,,0,1,1,0,1,1,1,1,1,0,25,0,3999,0
dnlgms,dnlgms,,0,2,2,0,2,2,1,1,1,0,19,0,4000,0
alessandrag87,alessandrag87,,0,2,2,0,2,2,1,1,1,0,76,0,4001,1
andrefran,andrefran,,0,2,2,0,2,2,1,1,1,0,19,0,4002,0
NorivalSSilva,NorivalSSilva,,0,1,1,0,1,1,1,1,1,0,4,0,4003,0
Guicaiosant,Guicaiosant,,0,1,1,0,1,1,2,0.571429,0.625,0,5,0,4004,0
Norska11,Norska11,,0,1,1,0,1,1,1,1,1,0,103,69,4005,0
LizauraN,LizauraN,,0,1,1,0,1,1,1,1,1,0,266,223,4007,0
ElFocoInforma,ElFocoInforma,,1,0,1,1,0,1,0,0,0,0,266,223,4006,0
LeaoInSolo,LeaoInSolo,,0,1,1,0,2,2,1,1,1,0,4,0,4008,0
herson_herbster,herson_herbster,,0,3,3,0,3,3,1,1,1,0,76,0,4009,0.333333
ninadhora,ninadhora,,0,2,2,0,2,2,1,1,1,0,76,0,4010,1
CarolAndion,CarolAndion,,0,2,2,0,2,2,1,1,1,0,76,0,4011,1
lusotupiniquim,lusotupiniquim,,0,2,2,0,2,2,1,1,1,0,76,0,4012,1
grazisalomao,grazisalomao,,0,1,1,0,1,1,1,1,1,0,102,0,4013,0
SigUfrgs,SigUfrgs,,0,2,2,0,2,2,1,1,1,0,76,0,4014,1
ricardosdag,ricardosdag,,0,2,2,0,2,2,1,1,1,0,76,0,4015,1
pedrop_pb,pedrop_pb,,0,2,2,0,2,2,1,1,1,0,76,0,4016,1
bettlejuice3vzs,bettlejuice3vzs,,0,1,1,0,1,1,1,1,1,0,267,224,4018,0
PontualPortal,PontualPortal,,1,0,1,1,0,1,0,0,0,0,267,224,4017,0
asirsrs,asirsrs,,0,1,1,0,1,1,1,1,1,0,268,225,4020,0
lukirawr,lukirawr,,1,0,1,1,0,1,0,0,0,0,268,225,4019,0
claurbertoldi,claurbertoldi,,0,1,1,0,1,1,2,0.571429,0.625,0,5,0,4021,0
edufig,edufig,,0,2,2,0,2,2,1,1,1,0,19,0,4022,0
leleueu,leleueu,,0,2,2,0,2,2,1,1,1,0,76,0,4023,1
HeamSreypov,HeamSreypov,,0,1,1,0,1,1,1,1,1,0,269,226,4025,0
brasil_ahf,brasil_ahf,,1,0,1,1,0,1,0,0,0,0,269,226,4024,0
AnglicaQuadros1,AnglicaQuadros1,,0,1,1,0,1,1,2,0.545455,0.583333,0,10,0,4026,0
mimmagalhaes,mimmagalhaes,,0,2,2,0,2,2,1,1,1,0,76,0,4027,1
aguilalibre22,aguilalibre22,,0,1,1,0,2,2,1,1,1,0,29,0,4028,0
LivinhaBuitrago,LivinhaBuitrago,,0,1,1,0,1,1,1,1,1,0,4,0,4029,0
danmaxis,danmaxis,,0,2,2,0,2,2,1,1,1,0,76,0,4030,1
sylviasiqueira_,sylviasiqueira_,,1,0,1,1,0,1,0,0,0,0,213,0,1764,0
ElielSeith,ElielSeith,,0,1,1,0,1,1,1,1,1,0,25,0,4031,0
dalmarsio,dalmarsio,,0,1,1,0,1,1,1,1,1,0,25,0,4032,0
ItzamaLopezY,ItzamaLopezY,,0,1,1,0,1,1,1,1,1,0,29,0,4033,0
descaralhads,descaralhads,,0,2,2,0,2,2,1,1,1,0,76,0,4034,1
crisforti_,crisforti_,,0,1,1,0,1,1,1,1,1,0,213,0,4035,0
jurujubee,jurujubee,,0,1,1,0,1,1,1,1,1,0,213,0,4036,0
AnselmoLobato,AnselmoLobato,,0,2,2,0,2,2,3,0.521739,0.569444,0,4,0,4037,1
Joana41858862,Joana41858862,,0,1,1,0,1,1,1,1,1,0,10,0,4038,0
tomleao,tomleao,,1,2,3,1,2,3,1,1,1,0,19,0,4039,0
flavialaham,flavialaham,,0,3,3,0,3,3,1,1,1,0,219,114,4040,0.333333
felipemlisboa,felipemlisboa,,0,1,1,0,1,1,2,0.545455,0.583333,0,10,0,4041,0
litos_l,litos_l,,0,2,2,0,2,2,1,1,1,0,76,0,4042,1
cldfnoticias,cldfnoticias,,1,0,1,1,0,1,0,0,0,0,153,0,2170,0
KenjiroORodrigo,KenjiroORodrigo,,0,2,2,0,2,2,1,1,1,0,76,0,4043,1
jpsilvano,jpsilvano,,0,2,2,0,2,2,3,0.521739,0.569444,0,4,0,4044,1
maquinaprofanaf,maquinaprofanaf,,1,0,1,1,0,1,0,0,0,0,0,0,104,0
gabrielfcp,gabrielfcp,,0,1,1,0,1,1,1,1,1,0,213,0,4045,0
CorresponsalsMX,CorresponsalsMX,,0,2,2,0,2,2,1,1,1,0,270,227,4048,0
Diocesis_Chalco,Diocesis_Chalco,,1,0,1,1,0,1,0,0,0,0,270,227,4047,0
Edomex,Edomex,,1,0,1,1,0,1,0,0,0,0,270,227,4046,0
CarraraRogerio,CarraraRogerio,,0,1,1,0,1,1,1,1,1,0,25,0,4049,0
Mfg2103,Mfg2103,,0,1,1,0,1,1,2,0.545455,0.583333,0,10,0,4050,0
TJrPereira81,TJrPereira81,,0,1,1,0,1,1,1,1,1,0,4,0,4051,0
senna70,senna70,,0,1,1,0,1,1,1,1,1,0,4,0,4052,0
cvu_cvu,cvu_cvu,,0,1,1,0,2,2,2,0.571429,0.625,0,5,0,4053,0
AdrianaT9735,AdrianaT9735,,0,3,3,0,3,3,1,1,1,0,56,34,4054,0
FabioPellegrini,FabioPellegrini,,0,1,1,0,1,1,2,0.6,0.666667,0,62,0,4055,0
Marciomac21,Marciomac21,,0,1,1,0,1,1,1,1,1,0,4,0,4056,0
Brasil08704642,Brasil08704642,,0,1,1,0,1,1,2,0.6,0.666667,0,62,0,4057,0
health_donn,health_donn,,0,1,1,0,1,1,1,1,1,0,213,0,4058,0
meuguIagminhav,meuguIagminhav,,0,1,1,0,1,1,1,1,1,0,41,0,4059,0
_ExploraDigital,_ExploraDigital,,2,28,30,2,41,43,2,0.966667,0.982759,0.000005,45,0,56,0.006158
kimpaim,kimpaim,,1,0,1,1,0,1,0,0,0,0,45,0,55,0
mates_pospa12,mates_pospa12,,0,1,1,0,1,1,1,1,1,0,41,0,4060,0
Felipe_Selol,Felipe_Selol,,0,1,1,0,1,1,1,1,1,0,25,0,4061,0
foragarimpo,foragarimpo,,0,1,1,0,1,1,1,1,1,0,41,0,4062,0
lecticia_paiva,lecticia_paiva,,0,1,1,0,1,1,1,1,1,0,19,0,4063,0
SandraRosaMada2,SandraRosaMada2,,0,1,1,0,1,1,1,1,1,0,41,0,4064,0
mariade57438723,mariade57438723,,0,1,1,0,1,1,1,1,1,0,41,0,4065,0
rfsaldanhario,rfsaldanhario,,0,1,1,0,1,1,2,0.571429,0.625,0,76,0,4066,0
ANDREBANIWA,ANDREBANIWA,,0,1,1,0,1,1,1,1,1,0,41,0,4067,0
TonetteRita,TonetteRita,,0,1,1,0,1,1,2,0.545455,0.583333,0,10,0,4068,0
chadeeucalipto,chadeeucalipto,,0,1,1,0,1,1,2,0.666667,0.75,0,0,0,4069,0
mat_foll,mat_foll,,1,0,1,1,0,1,0,0,0,0,0,0,103,0
ZMariaSiqueira1,ZMariaSiqueira1,,0,3,3,0,3,3,1,1,1,0,45,0,4072,0
AP_Consultoria,AP_Consultoria,,1,0,1,1,0,1,0,0,0,0,45,0,4071,0
brom_elisa,brom_elisa,,1,0,1,1,0,1,0,0,0,0,45,0,4070,0
RadioProletrio,RadioProletrio,,0,1,1,0,1,1,1,1,1,0,62,0,4073,0
JoabDantas3,JoabDantas3,,0,1,1,0,1,1,1,1,1,0,62,0,4074,0
confradamarvada,confradamarvada,,0,1,1,0,1,1,1,1,1,0,25,0,4075,0
paulofsr,paulofsr,,2,3,5,2,3,5,3,0.508772,0.528736,0,45,0,56,0.666667
r_piment,r_piment,,0,1,1,0,1,1,1,1,1,0,0,0,4076,0
magnus_bass,magnus_bass,,0,1,1,0,1,1,1,1,1,0,62,0,4077,0
mieresfilho,mieresfilho,,0,1,1,0,1,1,1,1,1,0,62,0,4078,0
BancodoBrasil,BancodoBrasil,,1,0,1,1,0,1,0,0,0,0,45,0,53,0
secomvc,secomvc,,1,0,1,1,0,1,0,0,0,0,45,0,51,0
Jerryfacha,Jerryfacha,,0,5,5,0,5,5,3,0.490741,0.525157,0,27,0,4079,0.5
Damadeferroofic,Damadeferroofic,,1,0,1,1,0,1,0,0,0,0,45,0,47,0
AnnaLciaLimaCa1,AnnaLciaLimaCa1,,1,0,1,1,0,1,0,0,0,0,45,0,46,0
giba_bsb,giba_bsb,,1,0,1,1,0,1,0,0,0,0,45,0,45,0
HELENINHARJ,HELENINHARJ,,1,0,1,1,0,1,0,0,0,0,45,0,44,0
PatySoelo,PatySoelo,,1,0,1,1,0,1,0,0,0,0,45,0,43,0
631Beckman,631Beckman,,1,0,1,1,0,1,0,0,0,0,45,0,42,0
joaowdf,joaowdf,,1,0,1,1,0,1,0,0,0,0,45,0,41,0
mandetta,mandetta,,1,0,1,1,0,1,0,0,0,0,45,0,40,0
Med176,Med176,,1,0,1,1,0,1,0,0,0,0,45,0,37,0
smarrupe,smarrupe,,0,1,1,0,1,1,1,1,1,0,19,0,4080,0
CBOZITO,CBOZITO,,1,0,1,1,0,1,0,0,0,0,45,0,35,0
alexandre,alexandre,,1,0,1,1,0,1,0,0,0,0,45,0,34,0
17cd7513772a4e7,17cd7513772a4e7,,0,5,5,0,5,5,3,0.490741,0.525157,0,27,0,4081,0.5
gsapiras,gsapiras,,1,0,1,1,0,1,0,0,0,0,45,0,33,0
LATAMAirlinesUS,LATAMAirlinesUS,,1,0,1,1,0,1,0,0,0,0,45,0,32,0
whysir1979,whysir1979,,1,0,1,1,0,1,0,0,0,0,45,0,31,0
vetomCO,vetomCO,,1,0,1,1,0,1,0,0,0,0,45,0,30,0
zannapipper,zannapipper,,0,1,1,0,1,1,1,1,1,0,25,0,4082,0
EdinaOl84432800,EdinaOl84432800,,0,1,1,0,1,1,2,0.545455,0.583333,0,10,0,4083,0
gaviaoreal13,gaviaoreal13,,0,1,1,0,1,1,1,1,1,0,271,228,4085,0
oficialmanausfc,oficialmanausfc,,1,0,1,1,0,1,0,0,0,0,271,228,4084,0
_mbdr_,_mbdr_,,1,0,1,1,0,1,0,0,0,0,8,0,1889,0
brunoal02852156,brunoal02852156,,0,1,1,0,1,1,1,1,1,0,25,0,4086,0
CanalBalneario,CanalBalneario,,0,2,2,0,2,2,1,1,1,0,272,229,4089,0
UDObasket,UDObasket,,1,0,1,1,0,1,0,0,0,0,272,229,4088,0
CabMadeira,CabMadeira,,1,0,1,1,0,1,0,0,0,0,272,229,4087,0
Maryuelle,Maryuelle,,0,1,1,0,1,1,1,1,1,0,273,0,4090,0
Mauzin5,Mauzin5,,6,0,6,6,0,6,0,0,0,0,273,0,102,0
ofelipeb,ofelipeb,,2,2,4,2,2,4,2,0.666667,0.75,0,19,0,4092,0
wsl,wsl,,1,0,1,1,0,1,0,0,0,0,19,0,4091,0
BinhoGua,BinhoGua,,0,1,1,0,1,1,1,1,1,0,25,0,4093,0
NatBini,NatBini,,0,1,1,0,1,1,1,1,1,0,274,230,4095,0
tvalmg,tvalmg,,1,0,1,1,0,1,0,0,0,0,274,230,4094,0
DGSaude,DGSaude,,3,0,3,3,0,3,0,0,0,0,8,0,1206,0
Rainhae88571043,Rainhae88571043,,0,2,2,0,2,2,1,1,1,0,275,231,4098,0.5
ZELIT,ZELIT,,1,1,2,1,1,2,1,1,1,0,275,231,4097,0.5
tracklist,tracklist,,2,0,2,2,0,2,0,0,0,0,275,231,4096,0.5
CensuradaSempr1,CensuradaSempr1,,0,2,2,0,2,2,1,1,1,0,276,232,4101,0
DeputadosDEM,DeputadosDEM,,1,0,1,1,0,1,0,0,0,0,276,232,4100,0
Alan_Rick,Alan_Rick,,1,0,1,1,0,1,0,0,0,0,276,232,4099,0
LeifSiv_Falk,LeifSiv_Falk,,0,1,1,0,1,1,1,1,1,0,273,0,4102,0
DalvioMachava,DalvioMachava,,0,2,2,0,2,2,1,1,1,0,166,126,4103,0.5
bernade20087270,bernade20087270,,0,1,1,0,1,1,1,1,1,0,25,0,4104,0
monica_resende,monica_resende,,0,2,2,0,2,2,2,0.6,0.666667,0,10,0,4105,0.5
eupaularaquel,eupaularaquel,,0,2,2,0,2,2,2,0.75,0.833333,0,71,0,4106,0.5
DamaresAlves,DamaresAlves,,8,0,8,8,0,8,0,0,0,0,71,0,1141,0.125
RUIALVESDASILV6,RUIALVESDASILV6,,0,2,2,0,2,2,1,1,1,0,27,0,4108,0.5
NiltoTatto,NiltoTatto,,3,1,4,3,1,4,1,1,1,0,27,0,4107,0.25
pcostafloripa,pcostafloripa,,0,1,1,0,1,1,2,0.6,0.666667,0,62,0,4109,0
ViennaForFuture,ViennaForFuture,,2,0,2,4,0,4,0,0,0,0,62,0,60,0.5
DanaButlerr,DanaButlerr,,0,2,2,0,2,2,2,0.75,0.833333,0,71,0,4110,0.5
Ni4Wein_70,Ni4Wein_70,,0,2,2,0,2,2,2,0.75,0.833333,0,71,0,4111,0.5
Alessan21893293,Alessan21893293,,0,1,1,0,2,2,1,1,1,0,19,0,4112,0
AlfredFresh2,AlfredFresh2,,0,1,1,0,1,1,1,1,1,0,273,0,4113,0
PontevedraViva,PontevedraViva,,0,1,1,0,1,1,1,1,1,0,277,233,4115,0
titimoki,titimoki,,1,0,1,1,0,1,0,0,0,0,277,233,4114,0
porcoerencia,porcoerencia,,0,1,1,0,1,1,1,1,1,0,278,234,4117,0
cafecomferri,cafecomferri,,1,0,1,1,0,1,0,0,0,0,278,234,4116,0
cefestellita1,cefestellita1,,0,1,1,0,1,1,2,0.545455,0.583333,0,10,0,4118,0
thiagoreira,thiagoreira,,1,0,1,1,0,1,0,0,0,0,0,0,101,0
VillainFernanda,VillainFernanda,,0,1,1,0,1,1,1,1,1,0,213,0,4119,0
LaBorocoto,LaBorocoto,,0,1,1,0,1,1,1,1,1,0,279,235,4121,0
EpochTimes,EpochTimes,,1,0,1,1,0,1,0,0,0,0,279,235,4120,0
FalaCeilandia,FalaCeilandia,,0,1,1,0,1,1,2,0.666667,0.75,0,0,0,4122,0
mariacpois,mariacpois,,0,1,1,0,2,2,1,1,1,0,8,0,4123,0
Donasenhoraa,Donasenhoraa,,0,1,1,0,1,1,1,1,1,0,213,0,4124,0
MarilizNery,MarilizNery,,0,1,1,0,1,1,1,1,1,0,88,0,4125,0
RosaLulaBrasil,RosaLulaBrasil,,0,1,1,0,1,1,1,1,1,0,88,0,4126,0
CangeranaK,CangeranaK,,0,2,2,0,2,2,1,1,1,0,76,0,4127,1
AndreFarfan10,AndreFarfan10,,0,2,2,0,2,2,1,1,1,0,19,0,4128,0
NassarCarmelena,NassarCarmelena,,0,1,1,0,1,1,2,0.545455,0.583333,0,10,0,4129,0
henriqueacqua,henriqueacqua,,2,0,2,2,0,2,0,0,0,0,0,0,100,0
shadow89242034,shadow89242034,,0,1,1,0,1,1,1,1,1,0,0,0,4130,0
guioliv15,guioliv15,,0,1,1,0,1,1,1,1,1,0,50,0,4131,0
rafaelbonnal,rafaelbonnal,,0,1,1,0,1,1,3,0.454545,0.533333,0,19,0,4132,0
FredLAFernandes,FredLAFernandes,,2,0,2,3,0,3,0,0,0,0,27,0,79,0.5
CEM_CMS,CEM_CMS,,1,0,1,1,0,1,0,0,0,0,213,0,2224,0
ronaldofla1981,ronaldofla1981,,0,3,3,0,3,3,4,0.452991,0.487421,0,27,0,4133,0.5
fazamor,fazamor,,0,1,1,0,1,1,3,0.454545,0.533333,0,19,0,4134,0
makeupoln,makeupoln,,0,1,1,0,2,2,1,1,1,0,80,0,4135,0
agateira_,agateira_,,0,1,1,0,1,1,1,1,1,0,88,0,4136,0
SirleiaRates,SirleiaRates,,0,1,1,0,1,1,1,1,1,0,0,0,4137,0
ReginaV39455988,ReginaV39455988,,0,1,1,0,1,1,1,1,1,0,280,236,4139,0
raullsantiago,raullsantiago,,3,0,3,3,0,3,0,0,0,0,280,236,4138,0
Debora_Aligieri,Debora_Aligieri,,0,1,1,0,1,1,1,1,1,0,281,237,4141,0
conselhomssp,conselhomssp,,1,0,1,1,0,1,0,0,0,0,281,237,4140,0
FerPauker,FerPauker,,0,1,1,0,1,1,1,1,1,0,282,238,4143,0
RadioPlayInter,RadioPlayInter,,1,0,1,1,0,1,0,0,0,0,282,238,4142,0
MarcinhoMeio,MarcinhoMeio,,0,1,1,0,1,1,1,1,1,0,283,239,4145,0
GloboNews,GloboNews,,1,0,1,1,0,1,0,0,0,0,283,239,4144,0
DiegoPozzi15,DiegoPozzi15,,0,1,1,0,1,1,1,1,1,0,284,240,4147,0
catoliconomundo,catoliconomundo,,2,0,2,2,0,2,0,0,0,0,284,240,4146,0
nemorensis_rex,nemorensis_rex,,0,1,1,0,1,1,1,1,1,0,88,0,4148,0
MarkRobin5,MarkRobin5,,0,1,1,0,1,1,1,1,1,0,88,0,4149,0
anesiobohn,anesiobohn,,0,1,1,0,1,1,1,1,1,0,88,0,4150,0
aflorbege,aflorbege,,0,1,1,0,1,1,1,1,1,0,88,0,4151,0
jvcampelo,jvcampelo,,0,1,1,0,1,1,1,1,1,0,88,0,4152,0
MulherItaipavah,MulherItaipavah,,0,1,1,0,1,1,1,1,1,0,88,0,4153,0
RibSte,RibSte,,0,1,1,0,1,1,1,1,1,0,88,0,4154,0
profsosa13,profsosa13,,0,1,1,0,1,1,1,1,1,0,88,0,4155,0
FURUKAVA,FURUKAVA,,0,1,1,0,1,1,1,1,1,0,88,0,4156,0
IrineuGuilherm,IrineuGuilherm,,0,1,1,0,1,1,1,1,1,0,88,0,4157,0
AntonimoSeu,AntonimoSeu,,0,1,1,0,1,1,1,1,1,0,88,0,4158,0
ManoelSSalomao,ManoelSSalomao,,0,1,1,0,1,1,1,1,1,0,284,240,4159,0
theonlywini,theonlywini,,0,1,1,0,1,1,1,1,1,0,19,0,4160,0
ijsn_es,ijsn_es,,2,3,5,2,3,5,1,1,1,0,285,241,4162,0.666667
cbnvitoria,cbnvitoria,,1,2,3,1,2,3,1,1,1,0,285,241,4162,0.5
PabloSilvaLira,PabloSilvaLira,,2,0,2,2,0,2,0,0,0,0,285,241,4161,1
hmarianeves,hmarianeves,,1,0,1,1,0,1,0,0,0,0,20,0,383,0
nelasilva,nelasilva,,1,0,1,1,0,1,0,0,0,0,20,0,382,0
xalasca,xalasca,,0,6,6,0,11,11,3,0.504762,0.540881,0,27,0,4163,0.366667
Ateixeira61,Ateixeira61,,0,1,1,0,2,2,1,1,1,0,8,0,4164,0
SIMONESANTOSGMA,SIMONESANTOSGMA,,0,1,1,0,1,1,1,1,1,0,213,0,4165,0
nikitabia,nikitabia,,0,1,1,0,1,1,1,1,1,0,19,0,4166,0
Marcia27643920,Marcia27643920,,0,1,1,0,1,1,1,1,1,0,50,0,4167,0
AndraCurtissAl1,AndraCurtissAl1,,0,2,2,0,2,2,2,0.6,0.666667,0,10,0,4168,0.5
inahso,inahso,,0,1,1,0,1,1,1,1,1,0,19,0,4169,0
KlovysSantosBr,KlovysSantosBr,,0,1,1,0,1,1,1,1,1,0,50,0,4170,0
torreshomem,torreshomem,,0,1,1,0,1,1,1,1,1,0,50,0,4171,0
paulboufive,paulboufive,,0,1,1,0,1,1,1,1,1,0,50,0,4172,0
DcsbeleDaniele,DcsbeleDaniele,,0,1,1,0,1,1,1,1,1,0,50,0,4173,0
megeam,megeam,,0,1,1,0,1,1,1,1,1,0,4,0,4174,0
pierrejlucas,pierrejlucas,,0,2,2,0,2,2,1,1,1,0,166,126,4175,0.5
a_rosa555,a_rosa555,,0,2,2,0,2,2,2,0.6,0.666667,0,10,0,4176,0.5
j_jblago,j_jblago,,0,1,1,0,1,1,1,1,1,0,213,0,4177,0
an85077937,an85077937,,0,1,1,0,1,1,2,0.545455,0.583333,0,10,0,4178,0
NRingeril,NRingeril,,0,1,1,0,1,1,2,0.545455,0.583333,0,10,0,4179,0
MariaCr39137251,MariaCr39137251,,0,1,1,0,1,1,1,1,1,0,213,0,4180,0
MApPBrito,MApPBrito,,0,1,1,0,1,1,1,1,1,0,213,0,4181,0
bedylicious,bedylicious,,0,2,2,0,2,2,1,1,1,0,166,126,4182,0.5
JMHinUK,JMHinUK,,0,1,1,0,1,1,2,0.6,0.666667,0,31,0,4183,0
KeliVeronezi,KeliVeronezi,,0,1,1,0,1,1,1,1,1,0,50,0,4184,0
isabelgimenes,isabelgimenes,,0,1,1,0,1,1,1,1,1,0,213,0,4185,0
euro_vieira,euro_vieira,,0,1,1,0,1,1,2,0.6,0.666667,0,62,0,4186,0
lorenalimajb,lorenalimajb,,0,1,1,0,2,2,1,1,1,0,19,0,4187,0
CorneteiroAmar,CorneteiroAmar,,0,1,1,0,1,1,1,1,1,0,4,0,4188,0
Robertagbetty,Robertagbetty,,0,1,1,0,1,1,1,1,1,0,19,0,4189,0
paulovrpereira,paulovrpereira,,0,1,1,0,1,1,1,1,1,0,19,0,4190,0
thiagorondo,thiagorondo,,0,1,1,0,1,1,1,1,1,0,19,0,4191,0
eublorenza,eublorenza,,0,1,1,0,1,1,1,1,1,0,213,0,4192,0
roadcyclistbcn,roadcyclistbcn,,0,2,2,0,2,2,2,0.625,0.7,0,286,91,4193,0.5
RichardCarapazM,RichardCarapazM,,3,0,3,3,0,3,0,0,0,0,286,91,1805,0.166667
nahcf,nahcf,,0,1,1,0,1,1,1,1,1,0,19,0,4194,0
JoseLuizIN,JoseLuizIN,,0,1,1,0,1,1,1,1,1,0,19,0,4195,0
BruhvianaN,BruhvianaN,,0,1,1,0,1,1,1,1,1,0,4,0,4196,0
Aisha_com_vida,Aisha_com_vida,,5,1,6,5,1,6,1,1,1,0,45,0,3608,0.166667
demetera2,demetera2,,0,2,2,0,2,2,1,1,1,0,27,0,4197,0.5
BBBSPA,BBBSPA,,0,1,1,0,1,1,1,1,1,0,27,0,4198,0
schrarstzhaupt,schrarstzhaupt,,2,0,2,2,0,2,0,0,0,0,27,0,74,0
DimasAntifa,DimasAntifa,,0,2,2,0,2,2,1,1,1,0,27,0,4199,0.5
MarieMa19068015,MarieMa19068015,,0,1,1,0,1,1,1,1,1,0,29,0,4200,0
GilsonDobbin,GilsonDobbin,,0,1,1,0,1,1,1,1,1,0,287,242,4202,0
clpcamara,clpcamara,,1,0,1,1,0,1,0,0,0,0,287,242,4201,0
cansiglieri,cansiglieri,,0,1,1,0,1,1,2,0.545455,0.583333,0,10,0,4203,0
BraboDeuza,BraboDeuza,,0,1,1,0,4,4,2,0.545455,0.583333,0,10,0,4204,0
debaharaujo,debaharaujo,,0,1,1,0,1,1,1,1,1,0,213,0,4205,0
elitebrazuca,elitebrazuca,,0,1,1,0,1,1,1,1,1,0,25,0,4206,0
veronesebru,veronesebru,,0,1,1,0,1,1,1,1,1,0,213,0,4207,0
Diego_lanca,Diego_lanca,,0,1,1,0,1,1,1,1,1,0,213,0,4208,0
Snia62579054,Snia62579054,,0,1,1,0,1,1,1,1,1,0,19,0,4209,0
goias_noticia,goias_noticia,,1,0,1,1,0,1,0,0,0,0,66,0,758,0
marungersauer,marungersauer,,0,1,1,0,1,1,1,1,1,0,213,0,4210,0
WaimiriAtroari9,WaimiriAtroari9,,0,1,1,0,1,1,2,0.545455,0.583333,0,10,0,4211,0
MiaKat007,MiaKat007,,0,1,1,0,1,1,1,1,1,0,8,0,4212,0
ro_lustosa,ro_lustosa,,0,5,5,0,5,5,3,0.490741,0.525157,0,27,0,4213,0.5
MartaRcf,MartaRcf,,0,1,1,0,1,1,1,1,1,0,213,0,4214,0
lGlaucial,lGlaucial,,0,1,1,0,1,1,1,1,1,0,19,0,4215,0
INEOSGrenadiers,INEOSGrenadiers,,1,0,1,1,0,1,0,0,0,0,286,91,1804,0
thiago_lanca,thiago_lanca,,0,1,1,0,1,1,1,1,1,0,213,0,4216,0
mary_maravilha,mary_maravilha,,0,1,1,0,1,1,1,1,1,0,213,0,4217,0
eduardprudencio,eduardprudencio,,0,1,1,0,1,1,1,1,1,0,280,236,4218,0
elis_toso,elis_toso,,0,1,1,0,1,1,1,1,1,0,213,0,4219,0
CristinaAlbern4,CristinaAlbern4,,0,1,1,0,2,2,2,0.545455,0.583333,0,10,0,4220,0
ninalemos,ninalemos,,0,1,1,0,1,1,1,1,1,0,213,0,4221,0
BNODesk,BNODesk,,1,0,1,1,0,1,0,0,0,0,10,0,9,0
BollyNumbers,BollyNumbers,,2,0,2,3,0,3,0,0,0,0,288,181,3067,1
luizcarlostavo1,luizcarlostavo1,,0,1,1,0,1,1,2,0.666667,0.75,0,177,137,4222,0
RaquelM00231509,RaquelM00231509,,0,1,1,0,1,1,1,1,1,0,156,117,4223,0
miguelrude,miguelrude,,0,1,1,0,1,1,1,1,1,0,19,0,4224,0
DiegoUlissi,DiegoUlissi,,1,0,1,1,0,1,0,0,0,0,286,91,2199,0
juann_ayuso,juann_ayuso,,1,0,1,1,0,1,0,0,0,0,286,91,2198,0
fatima_mirandab,fatima_mirandab,,0,1,1,0,1,1,1,1,1,0,213,0,4225,0
tuliovsb,tuliovsb,,0,1,1,0,1,1,2,0.545455,0.583333,0,10,0,4226,0
Anibalbueno,Anibalbueno,,0,1,1,0,1,1,2,0.545455,0.583333,0,10,0,4227,0
RaphaRST_BR,RaphaRST_BR,,0,2,2,0,2,2,1,1,1,0,45,0,4228,0.5
DemocraciaSempr,DemocraciaSempr,,0,1,1,0,1,1,1,1,1,0,213,0,4229,0
simoesap,simoesap,,0,1,1,0,1,1,1,1,1,0,213,0,4230,0
otavio_ranzani,otavio_ranzani,,0,1,1,0,1,1,1,1,1,0,19,0,4231,0
bluegrispaper,bluegrispaper,,0,1,1,0,1,1,1,1,1,0,213,0,4232,0
thaiscomacento,thaiscomacento,,0,1,1,0,1,1,1,1,1,0,213,0,4233,0
mallorcadiario,mallorcadiario,,1,0,1,1,0,1,0,0,0,0,0,0,57,0
mlfornara,mlfornara,,0,2,2,0,2,2,1,1,1,0,166,126,4234,0.5
FlorDeserto,FlorDeserto,,0,1,1,0,2,2,1,1,1,0,289,243,4236,0
dycovid,dycovid,,1,0,1,2,0,2,0,0,0,0,289,243,4235,0
OOzeasimoes,OOzeasimoes,,0,1,1,0,1,1,2,0.545455,0.583333,0,10,0,4237,0
sydaiam,sydaiam,,0,5,5,0,5,5,3,0.490741,0.525157,0,27,0,4238,0.5
MarverBrasil,MarverBrasil,,0,1,1,0,1,1,1,1,1,0,0,0,4239,0
Victoria05061,Victoria05061,,0,3,3,0,3,3,1,1,1,0,290,244,4243,0
nhk_news,nhk_news,,1,0,1,1,0,1,0,0,0,0,290,244,4242,0
NoticiasUno,NoticiasUno,,1,0,1,1,0,1,0,0,0,0,290,244,4241,0
epochtimes_jp,epochtimes_jp,,1,0,1,1,0,1,0,0,0,0,290,244,4240,0
FreddyDultra,FreddyDultra,,0,1,1,0,1,1,1,1,1,0,291,245,4245,0
agimediata,agimediata,,1,0,1,1,0,1,0,0,0,0,291,245,4244,0
abelhudaknb,abelhudaknb,,0,1,1,0,1,1,1,1,1,0,213,0,4246,0
lunalukaluz,lunalukaluz,,0,1,1,0,1,1,1,1,1,0,213,0,4247,0
catandobads,catandobads,,0,1,1,0,1,1,1,1,1,0,19,0,4248,0
denisessv,denisessv,,0,1,1,0,1,1,1,1,1,0,25,0,4249,0
AlessandroGilBR,AlessandroGilBR,,0,1,1,0,1,1,1,1,1,0,19,0,4250,0
gustavola,gustavola,,0,1,1,0,1,1,1,1,1,0,19,0,4251,0
thiagofc1982,thiagofc1982,,0,1,1,0,1,1,1,1,1,0,38,0,4252,0
Steve1Rod1Burch,Steve1Rod1Burch,,0,1,1,0,1,1,2,0.666667,0.75,0,3,3,4253,0
DeNearco,DeNearco,,0,1,1,0,1,1,1,1,1,0,4,0,4254,0
carlosaraujogyn,carlosaraujogyn,,0,1,1,0,1,1,1,1,1,0,50,0,4255,0
LucianaRaposo6,LucianaRaposo6,,0,3,3,0,3,3,1,1,1,0,19,0,4256,0
ethereal_w1tch,ethereal_w1tch,,0,1,1,0,1,1,1,1,1,0,213,0,4257,0
claudia20653209,claudia20653209,,0,1,1,0,1,1,2,0.545455,0.583333,0,10,0,4258,0
RobertoHecke,RobertoHecke,,0,1,1,0,1,1,1,1,1,0,50,0,4259,0
pchopner,pchopner,,0,1,1,0,1,1,2,0.545455,0.583333,0,10,0,4260,0
mauvelasco,mauvelasco,,0,1,1,0,1,1,2,0.545455,0.583333,0,10,0,4261,0
DanniBonet23,DanniBonet23,,0,1,1,0,1,1,1,1,1,0,280,236,4262,0
Raffa_MRP,Raffa_MRP,,0,1,1,0,1,1,1,1,1,0,19,0,4263,0
Laramarx,Laramarx,,0,1,1,0,1,1,1,1,1,0,38,0,4264,0
DavisMiranda2,DavisMiranda2,,0,1,1,0,1,1,2,0.545455,0.583333,0,10,0,4265,0
Daniel11773494,Daniel11773494,,0,1,1,0,1,1,1,1,1,0,80,0,4266,0
EdgarDe_Latorre,EdgarDe_Latorre,,0,1,1,0,1,1,1,1,1,0,19,0,4267,0
maml_t,maml_t,,0,1,1,0,1,1,1,1,1,0,29,0,4268,0
afpriscila,afpriscila,,0,1,1,0,1,1,1,1,1,0,213,0,4269,0
CNSaude,CNSaude,,1,0,1,1,0,1,0,0,0,0,0,0,28,0
VladimirLusiada,VladimirLusiada,,0,1,1,0,1,1,1,1,1,0,213,0,4270,0
NMarxista13,NMarxista13,,0,1,1,0,1,1,1,1,1,0,19,0,4271,0
TeteDeBoa,TeteDeBoa,,0,1,1,0,1,1,1,1,1,0,213,0,4272,0
MariaEl13555088,MariaEl13555088,,0,1,1,0,1,1,1,1,1,0,292,246,4274,0
DrEmilyThomas,DrEmilyThomas,,1,0,1,1,0,1,0,0,0,0,292,246,4273,0
vagnocarvalho,vagnocarvalho,,0,1,1,0,1,1,1,1,1,0,293,247,4276,0
POTUS,POTUS,,1,0,1,1,0,1,0,0,0,0,293,247,4275,0
VzEsquerdalha,VzEsquerdalha,,0,1,1,0,1,1,1,1,1,0,80,0,4277,0
MatheusKnothe,MatheusKnothe,,0,1,1,0,1,1,2,0.545455,0.583333,0,10,0,4278,0
thatybene,thatybene,,0,2,2,0,2,2,2,0.6,0.666667,0,10,0,4279,0.5
LutzLeo,LutzLeo,,0,1,1,0,1,1,1,1,1,0,19,0,4280,0
_hi_bell_,_hi_bell_,,0,1,1,0,1,1,1,1,1,0,19,0,4281,0
chizeyrita,chizeyrita,,0,1,1,0,1,1,1,1,1,0,29,0,4282,0
ruan_fdc,ruan_fdc,,0,2,2,0,2,2,4,0.461538,0.534722,0,4,0,4283,1
CristoJesusFe,CristoJesusFe,,0,1,1,0,1,1,1,1,1,0,27,0,4284,0
sbasilio28,sbasilio28,,0,1,1,0,1,1,1,1,1,0,19,0,4285,0
RodrigoCesarM10,RodrigoCesarM10,,0,1,1,0,1,1,1,1,1,0,19,0,4286,0
SoniaBridi,SoniaBridi,,0,1,1,0,1,1,1,1,1,0,19,0,4287,0
murtaa,murtaa,,0,1,1,0,1,1,1,1,1,0,19,0,4288,0
luizacaires3,luizacaires3,,0,1,1,0,1,1,1,1,1,0,19,0,4289,0
redeTVT,redeTVT,,2,0,2,2,0,2,0,0,0,0,41,0,929,0
Anajuliamnovais,Anajuliamnovais,,0,1,1,0,1,1,1,1,1,0,5,0,4290,0
DoniseteSilveir,DoniseteSilveir,,0,1,1,0,1,1,1,1,1,0,4,0,4291,0
pcbpaula,pcbpaula,,0,1,1,0,1,1,1,1,1,0,19,0,4292,0
mariaduducelina,mariaduducelina,,0,1,1,0,1,1,1,1,1,0,213,0,4293,0
TaisFitaroni,TaisFitaroni,,0,1,1,0,1,1,2,0.545455,0.583333,0,10,0,4294,0
BBB2Van,BBB2Van,,0,1,1,0,1,1,1,1,1,0,5,0,4295,0
Direitudo1,Direitudo1,,0,1,1,0,1,1,1,1,1,0,80,0,4296,0
sojpaqui,sojpaqui,,0,1,1,0,1,1,1,1,1,0,80,0,4297,0
candeIaferreira,candeIaferreira,,0,1,1,0,1,1,1,1,1,0,294,248,4299,0
gonzzalez_2,gonzzalez_2,,1,0,1,1,0,1,0,0,0,0,294,248,4298,0
framos10,framos10,,1,0,1,1,0,1,0,0,0,0,31,0,1535,0
toutatis16,toutatis16,,1,0,1,1,0,1,0,0,0,0,31,0,1534,0
jorgeclpires,jorgeclpires,,1,0,1,1,0,1,0,0,0,0,31,0,1533,0
Todaaverdadept,Todaaverdadept,,1,0,1,1,0,1,0,0,0,0,31,0,1532,0
obloqueames,obloqueames,,0,2,2,0,2,2,1,1,1,0,295,249,4302,0
montseprado,montseprado,,23,0,23,23,0,23,0,0,0,0,295,249,4301,0
obloque,obloque,,23,0,23,23,0,23,0,0,0,0,295,249,4300,0
UERJ_oficial,UERJ_oficial,,2,0,2,2,0,2,0,0,0,0,0,0,27,0.5
192905V,192905V,,0,1,1,0,1,1,1,1,1,0,29,0,4303,0
FabsFrigga,FabsFrigga,,1,0,1,1,0,1,0,0,0,0,27,0,75,0
BonnerPutasso,BonnerPutasso,,1,0,1,1,0,1,0,0,0,0,27,0,73,0
SeixoDani,SeixoDani,,0,2,2,0,2,2,1,1,1,0,295,249,4304,0
omoraiz,omoraiz,,0,1,1,0,1,1,1,1,1,0,88,0,4305,0
chesare1481,chesare1481,,0,1,1,0,1,1,1,1,1,0,29,0,4306,0
SimoneBaddo,SimoneBaddo,,0,1,1,0,1,1,1,1,1,0,88,0,4307,0
leilabrasilmax1,leilabrasilmax1,,0,1,1,0,1,1,1,1,1,0,88,0,4308,0
vangelofreebird,vangelofreebird,,0,1,1,0,1,1,1,1,1,0,296,250,4310,0
sapo,sapo,,1,0,1,1,0,1,0,0,0,0,296,250,4309,0
cesarc95,cesarc95,,0,1,1,0,1,1,1,1,1,0,50,0,4311,0
LoliPier,LoliPier,,0,2,2,0,2,2,1,1,1,0,295,249,4312,0
CarlossEduua,CarlossEduua,,0,1,1,0,1,1,2,0.545455,0.583333,0,10,0,4313,0
Vino_Vieira,Vino_Vieira,,0,1,1,0,1,1,1,1,1,0,213,0,4314,0
BrasilMito2022,BrasilMito2022,,2,0,2,2,0,2,0,0,0,0,45,0,21,0.5
joaoalbertolima,joaoalbertolima,,0,2,2,0,2,2,1,1,1,0,297,251,4317,0.5
NoticiasdoPARA,NoticiasdoPARA,,7,1,8,7,1,8,1,1,1,0,297,251,4316,0.125
WesleySafadao,WesleySafadao,,8,0,8,8,0,8,0,0,0,0,297,251,4315,0.125
MayosDavis,MayosDavis,,0,1,1,0,1,1,2,0.545455,0.583333,0,10,0,4318,0
ThomasFreedomF1,ThomasFreedomF1,,0,2,2,0,2,2,2,0.583333,0.642857,0,19,0,4319,0
dieginho77,dieginho77,,0,2,2,0,2,2,1,1,1,0,295,249,4320,0
pedro_borges_fl,pedro_borges_fl,,0,1,1,0,1,1,2,0.545455,0.583333,0,10,0,4321,0
JuliaMArgollo,JuliaMArgollo,,0,1,1,0,1,1,2,0.545455,0.583333,0,10,0,4322,0
rafastyles69,rafastyles69,,0,2,2,0,18,18,2,0.666667,0.75,0,5,0,4323,0.5
azeitona576,azeitona576,,0,1,1,0,1,1,2,0.545455,0.583333,0,10,0,4324,0
niltonbranco,niltonbranco,,0,1,1,0,1,1,2,0.545455,0.583333,0,10,0,4325,0
jcmonteiro50,jcmonteiro50,,0,1,1,0,2,2,1,1,1,0,50,0,4326,0
tarummie,tarummie,,0,1,1,0,1,1,1,1,1,0,41,0,4327,0
Bruce_Albert,Bruce_Albert,,0,1,1,0,1,1,1,1,1,0,41,0,4328,0
RuralRudeboyGZ,RuralRudeboyGZ,,0,2,2,0,2,2,1,1,1,0,295,249,4329,0
coisa4829,coisa4829,,0,1,1,0,1,1,1,1,1,0,41,0,4330,0
de_bubuia_,de_bubuia_,,0,1,1,0,1,1,1,1,1,0,41,0,4331,0
rocivaldo1,rocivaldo1,,0,2,2,0,2,2,1,1,1,0,297,251,4332,0.5
adla_salim,adla_salim,,0,1,1,0,1,1,1,1,1,0,50,0,4333,0
TifaritiB,TifaritiB,,0,2,2,0,2,2,1,1,1,0,295,249,4334,0
JessieSlytherin,JessieSlytherin,,1,0,1,1,0,1,0,0,0,0,0,0,19,0
lzrbay,lzrbay,,0,2,2,0,2,2,1,1,1,0,297,251,4335,0.5
JacqueleneC,JacqueleneC,,0,2,2,0,2,2,1,1,1,0,295,249,4336,0
FinaPereira5,FinaPereira5,,0,2,2,0,2,2,1,1,1,0,295,249,4337,0
Westsahara1976,Westsahara1976,,0,2,2,0,2,2,1,1,1,0,295,249,4338,0
xcgcampo,xcgcampo,,0,2,2,0,2,2,1,1,1,0,295,249,4339,0
kikinhov,kikinhov,,0,2,2,0,2,2,1,1,1,0,295,249,4340,0
Waldenilsonrobe,Waldenilsonrobe,,0,1,1,0,1,1,1,1,1,0,25,0,4341,0
NestorRego,NestorRego,,0,2,2,0,2,2,1,1,1,0,295,249,4342,0
SrtaBlenda,SrtaBlenda,,0,1,1,0,1,1,1,1,1,0,76,0,4343,0
Patrici99253358,Patrici99253358,,0,1,1,0,1,1,1,1,1,0,29,0,4344,0
MarcosMairton,MarcosMairton,,0,1,1,0,1,1,1,1,1,0,76,0,4345,0
luchinhagz,luchinhagz,,0,2,2,0,2,2,1,1,1,0,295,249,4346,0
DanielWill33,DanielWill33,,0,2,2,0,2,2,1,1,1,0,297,251,4347,0.5
EgidioNeri2,EgidioNeri2,,0,1,1,0,3,3,1,1,1,0,4,0,4348,0
neam____,neam____,,0,1,1,0,1,1,1,1,1,0,71,0,4349,0
JessicaChata00,JessicaChata00,,0,1,1,0,1,1,2,0.545455,0.583333,0,10,0,4350,0
anacarolinawat,anacarolinawat,,0,1,1,0,1,1,1,1,1,0,76,0,4351,0
odinelsom,odinelsom,,0,2,2,0,2,2,1,1,1,0,297,251,4352,0.5
okthaina,okthaina,,0,1,1,0,1,1,1,1,1,0,76,0,4353,0
Cassioshiuay,Cassioshiuay,,0,2,2,0,2,2,1,1,1,0,295,249,4354,0
Juanperdomo1973,Juanperdomo1973,,0,2,2,0,2,2,1,1,1,0,295,249,4355,0
Sahara_1951,Sahara_1951,,0,2,2,0,2,2,1,1,1,0,295,249,4356,0
tradutrouxa,tradutrouxa,,0,1,1,0,1,1,2,0.545455,0.583333,0,10,0,4357,0
juniorgueta,juniorgueta,,0,2,2,0,2,2,1,1,1,0,297,251,4358,0.5
Jorge57849149,Jorge57849149,,0,2,2,0,2,2,2,0.75,0.833333,0,71,0,4359,0.5
IvoneCastro,IvoneCastro,,0,1,1,0,1,1,2,0.545455,0.583333,0,10,0,4360,0
ChacalSiqueira,ChacalSiqueira,,0,1,1,0,1,1,2,0.545455,0.583333,0,10,0,4361,0
Jorge74V,Jorge74V,,0,1,1,0,1,1,1,1,1,0,8,0,4362,0
SBTonlinefas,SBTonlinefas,,0,1,1,0,1,1,1,1,1,0,298,252,4364,0
SBTwell,SBTwell,,2,0,2,2,0,2,0,0,0,0,298,252,4363,0
rodrigoestrela_,rodrigoestrela_,,0,1,1,0,2,2,1,1,1,0,66,0,4365,0
mendanhagustavo,mendanhagustavo,,0,1,1,0,2,2,1,1,1,0,66,0,4366,0
bbbriooficial,bbbriooficial,,0,1,1,0,1,1,1,1,1,0,298,252,4367,0
Pequenakarine,Pequenakarine,,0,1,1,0,1,1,2,0.545455,0.583333,0,10,0,4368,0
Carmen38116791,Carmen38116791,,0,2,2,0,2,2,1,1,1,0,295,249,4369,0
eOliveiraSC30,eOliveiraSC30,,0,1,1,0,1,1,2,0.545455,0.583333,0,10,0,4370,0
CarmelaSaians,CarmelaSaians,,0,2,2,0,2,2,1,1,1,0,295,249,4371,0
rubencela,rubencela,,0,2,2,0,2,2,1,1,1,0,295,249,4372,0
BNGEuropa,BNGEuropa,,0,2,2,0,2,2,1,1,1,0,295,249,4373,0
GalizaUPG,GalizaUPG,,0,2,2,0,2,2,1,1,1,0,295,249,4374,0
doce_raquel,doce_raquel,,0,2,2,0,2,2,1,1,1,0,295,249,4375,0
universodeART,universodeART,,1,0,1,1,0,1,0,0,0,0,0,0,18,0
duartecorreaGZ,duartecorreaGZ,,0,2,2,0,2,2,1,1,1,0,295,249,4376,0
JerriDias,JerriDias,,0,1,1,0,1,1,1,1,1,0,25,0,4377,0
realmice,realmice,,0,2,2,0,2,2,1,1,1,0,45,0,4378,0.5
_miissangell,_miissangell,,0,1,1,0,1,1,1,1,1,0,80,0,4379,0
redesampaio,redesampaio,,0,1,1,0,1,1,1,1,1,0,76,0,4380,0
kedneygalvao,kedneygalvao,,0,2,2,0,2,2,1,1,1,0,297,251,4381,0.5
RonaldoPradode2,RonaldoPradode2,,0,1,1,0,1,1,1,1,1,0,76,0,4382,0
DeboraMarotti,DeboraMarotti,,0,1,1,0,1,1,1,1,1,0,38,0,4383,0
Sarinhah013,Sarinhah013,,0,1,1,0,1,1,1,1,1,0,76,0,4384,0
liamabat,liamabat,,0,1,1,0,1,1,2,0.545455,0.583333,0,10,0,4385,0
joelcardona2,joelcardona2,,0,1,1,0,1,1,1,1,1,0,299,253,4387,0
SCT_Durango,SCT_Durango,,1,0,1,1,0,1,0,0,0,0,299,253,4386,0
v_rebeque,v_rebeque,,0,1,1,0,1,1,1,1,1,0,50,0,4388,0
xaconha,xaconha,,0,1,1,0,1,1,1,1,1,0,80,0,4389,0
JosCarlosMSilv2,JosCarlosMSilv2,,0,1,1,0,1,1,1,1,1,0,50,0,4390,0
freudflisntone,freudflisntone,,0,1,1,0,1,1,1,1,1,0,50,0,4391,0
domingoszatti,domingoszatti,,0,2,2,0,2,2,3,0.529412,0.592593,0,76,0,4392,0
pelintrate,pelintrate,,0,1,1,0,1,1,2,0.545455,0.583333,0,10,0,4393,0
AUSTRALIANO1980,AUSTRALIANO1980,,0,2,2,0,2,2,1,1,1,0,300,254,4396,0
mirmanogueira,mirmanogueira,,1,0,1,1,0,1,0,0,0,0,300,254,4395,0
NinaLuz23695256,NinaLuz23695256,,1,0,1,1,0,1,0,0,0,0,300,254,4394,0
BoyDjamass,BoyDjamass,,0,1,1,0,1,1,1,1,1,0,71,0,4397,0
gerardogeo,gerardogeo,,0,1,1,0,1,1,1,1,1,0,76,0,4398,0
marceloknobel,marceloknobel,,0,1,1,0,1,1,1,1,1,0,76,0,4399,0
merdadocarai,merdadocarai,,0,1,1,0,1,1,1,1,1,0,76,0,4400,0
DjairSergio,DjairSergio,,0,1,1,0,1,1,1,1,1,0,76,0,4401,0
KriGalocha,KriGalocha,,0,1,1,0,1,1,1,1,1,0,76,0,4402,0
adamoantonioni,adamoantonioni,,0,1,1,0,1,1,1,1,1,0,76,0,4403,0
Geraldo_14F,Geraldo_14F,,0,1,1,0,1,1,1,1,1,0,76,0,4404,0
Alfredo_JuanG,Alfredo_JuanG,,0,1,1,0,1,1,1,1,1,0,76,0,4405,0
rdigosilva,rdigosilva,,0,1,1,0,1,1,1,1,1,0,76,0,4406,0
AngelAlves,AngelAlves,,0,1,1,0,1,1,1,1,1,0,76,0,4407,0
freitxs,freitxs,,0,1,1,0,1,1,2,0.545455,0.583333,0,10,0,4408,0
ivonepita,ivonepita,,0,1,1,0,1,1,2,0.545455,0.583333,0,10,0,4409,0
ousiadasein,ousiadasein,,1,0,1,1,0,1,0,0,0,0,214,173,2895,0
arlanfranca,arlanfranca,,0,1,1,0,1,1,3,0.5,0.541667,0,76,0,4410,0
KailanRickelme_,KailanRickelme_,,0,1,1,0,1,1,1,1,1,0,0,0,4411,0
carinprediger,carinprediger,,0,1,1,0,1,1,1,1,1,0,301,255,4413,0
CrisBonorino,CrisBonorino,,1,0,1,1,0,1,0,0,0,0,301,255,4412,0
atelieracabou,atelieracabou,,0,1,1,0,1,1,2,0.545455,0.583333,0,10,0,4414,0
Camilleswan3,Camilleswan3,,0,1,1,0,1,1,2,0.545455,0.583333,0,10,0,4415,0
euronewspt,euronewspt,,2,0,2,2,0,2,0,0,0,0,25,0,3331,0
verdeamarelou,verdeamarelou,,0,1,1,0,1,1,1,1,1,0,25,0,4416,0
Enicomputer,Enicomputer,,1,0,1,2,0,2,0,0,0,0,0,0,17,0
Sogrommg,Sogrommg,,0,1,1,0,1,1,1,1,1,0,302,256,4418,0
GreatResetMood,GreatResetMood,,1,0,1,1,0,1,0,0,0,0,302,256,4417,0
oquestao,oquestao,,0,1,1,0,1,1,2,0.545455,0.583333,0,10,0,4419,0
ZHenrique6,ZHenrique6,,0,1,1,0,1,1,1,1,1,0,303,257,4421,0
inconfidenciafm,inconfidenciafm,,1,0,1,1,0,1,0,0,0,0,303,257,4420,0
letys_amonica,letys_amonica,,0,1,1,0,1,1,1,1,1,0,4,0,4422,0
SilaCinnamon,SilaCinnamon,,0,1,1,0,1,1,2,0.545455,0.583333,0,10,0,4423,0
gutobertagnoli,gutobertagnoli,,0,1,1,0,1,1,2,0.545455,0.583333,0,10,0,4424,0
StarLadie13,StarLadie13,,0,1,1,0,1,1,2,0.545455,0.583333,0,10,0,4425,0
adrianobolo,adrianobolo,,0,1,1,0,1,1,2,0.545455,0.583333,0,10,0,4426,0
ntilikinabrasil,ntilikinabrasil,,0,1,1,0,1,1,2,0.545455,0.583333,0,10,0,4427,0
HALtoridade,HALtoridade,,0,1,1,0,1,1,2,0.6,0.666667,0,62,0,4428,0
LeSarturiP,LeSarturiP,,0,1,1,0,1,1,2,0.545455,0.583333,0,10,0,4429,0
galo__vasco,galo__vasco,,0,1,1,0,1,1,2,0.545455,0.583333,0,10,0,4430,0
carolmarcal83,carolmarcal83,,0,1,1,0,1,1,2,0.545455,0.583333,0,10,0,4431,0
carapanarana,carapanarana,,0,1,1,0,1,1,2,0.545455,0.583333,0,10,0,4432,0
__valdeco,__valdeco,,0,1,1,0,1,1,2,0.545455,0.583333,0,10,0,4433,0
virgochris_,virgochris_,,0,1,1,0,1,1,2,0.6,0.666667,0,124,89,4434,0
av_sisepuede,av_sisepuede,,0,4,4,0,4,4,1,1,1,0,304,258,4439,0
Vox_CortesCyL,Vox_CortesCyL,,1,0,1,1,0,1,0,0,0,0,304,258,4438,0
vox_es,vox_es,,1,0,1,1,0,1,0,0,0,0,304,258,4437,0
madrid_vox,madrid_vox,,1,0,1,1,0,1,0,0,0,0,304,258,4436,0
VOX_Congreso,VOX_Congreso,,1,0,1,1,0,1,0,0,0,0,304,258,4435,0
16tiagosilva,16tiagosilva,,0,1,1,0,1,1,1,1,1,0,305,259,4441,0
Sumbatico,Sumbatico,,1,0,1,1,0,1,0,0,0,0,305,259,4440,0
IrmaRey66393165,IrmaRey66393165,,0,1,1,0,1,1,1,1,1,0,29,0,4442,0
wendersonpqdt,wendersonpqdt,,0,1,1,0,1,1,1,1,1,0,4,0,4443,0
KATIACORINO,KATIACORINO,,0,1,1,0,1,1,2,0.545455,0.583333,0,10,0,4444,0
US1stGentleman,US1stGentleman,,0,1,1,0,1,1,1,1,1,0,306,260,4446,0
D_USImmigration,D_USImmigration,,1,0,1,1,0,1,0,0,0,0,306,260,4445,0
Regis99,Regis99,,0,2,2,0,2,2,1,1,1,0,45,0,4447,0.5
jorgejaimes01,jorgejaimes01,,0,1,1,0,1,1,1,1,1,0,307,261,4449,0
DelkerMeluu,DelkerMeluu,,1,0,1,1,0,1,0,0,0,0,307,261,4448,0
FelipeVillagmez,FelipeVillagmez,,0,1,1,0,1,1,1,1,1,0,29,0,4450,0
Boubou74950763,Boubou74950763,,0,1,1,0,1,1,1,1,1,0,273,0,4451,0
TiaWeintraub,TiaWeintraub,,0,2,2,0,2,2,2,0.75,0.833333,0,71,0,4452,0.5
nwksandoval,nwksandoval,,0,1,1,0,1,1,1,1,1,0,29,0,4453,0
ReginaC82796833,ReginaC82796833,,0,1,1,0,1,1,1,1,1,0,19,0,4454,0
helena7rocha,helena7rocha,,0,1,1,0,1,1,1,1,1,0,19,0,4455,0
CatherineRuz2,CatherineRuz2,,0,1,1,0,1,1,1,1,1,0,29,0,4456,0
DornellesSalete,DornellesSalete,,0,2,2,0,2,2,2,0.666667,0.75,0,5,0,4457,0.5
xandaodalapa,xandaodalapa,,0,1,1,0,1,1,2,0.6,0.666667,0,62,0,4458,0
PerukaKatia,PerukaKatia,,0,1,1,0,1,1,2,0.545455,0.583333,0,10,0,4459,0
prince_carvalho,prince_carvalho,,0,1,1,0,1,1,1,1,1,0,273,0,4460,0
Patriciayahoo,Patriciayahoo,,0,1,1,0,7,7,2,0.571429,0.625,0,5,0,4461,0
Be3eto,Be3eto,,0,1,1,0,1,1,2,0.545455,0.583333,0,10,0,4462,0
AnaPaulaSBical1,AnaPaulaSBical1,,0,2,2,0,2,2,1,1,1,0,76,0,4463,1
BlogsBrasil,BlogsBrasil,,0,1,1,0,1,1,1,1,1,0,308,262,4465,0
ANALUCIAMcardio,ANALUCIAMcardio,,2,0,2,2,0,2,0,0,0,0,308,262,4464,0
icesarmelo,icesarmelo,,0,2,2,0,2,2,1,1,1,0,309,263,4468,0
MarcioAllemand1,MarcioAllemand1,,1,0,1,1,0,1,0,0,0,0,309,263,4467,0
CarlosBolsonaro,CarlosBolsonaro,,1,0,1,1,0,1,0,0,0,0,309,263,4466,0
aldotorresv81,aldotorresv81,,0,1,1,0,1,1,1,1,1,0,310,264,4470,0
HoyEstado,HoyEstado,,1,0,1,1,0,1,0,0,0,0,310,264,4469,0
ElisabethGanter,ElisabethGanter,,0,1,1,0,1,1,1,1,1,0,311,265,4472,0
CarlosBezerraJr,CarlosBezerraJr,,1,0,1,1,0,1,0,0,0,0,311,265,4471,0
estadaoverifica,estadaoverifica,,1,0,1,1,0,1,0,0,0,0,0,0,231,0
aosfatos,aosfatos,,1,0,1,1,0,1,0,0,0,0,0,0,230,0
agencialupa,agencialupa,,1,0,1,1,0,1,0,0,0,0,0,0,229,0
fatooufake,fatooufake,,1,0,1,1,0,1,0,0,0,0,0,0,228,0
abril,abril,,1,0,1,1,0,1,0,0,0,0,0,0,226,0
dansesurlamerde,dansesurlamerde,,0,1,1,0,1,1,2,0.545455,0.583333,0,10,0,4473,0
fernandokrammer,fernandokrammer,,0,1,1,0,1,1,1,1,1,0,0,0,4474,0
AcsAngelica,AcsAngelica,,2,0,2,2,0,2,0,0,0,0,0,0,16,0
MaosNova,MaosNova,,0,1,1,0,1,1,2,0.545455,0.583333,0,10,0,4475,0
Gabi_A_Garcia,Gabi_A_Garcia,,0,1,1,0,1,1,1,1,1,0,19,0,4476,0
MarcoocramAlan,MarcoocramAlan,,0,1,1,0,1,1,1,1,1,0,25,0,4477,0
ProjetoCiencia,ProjetoCiencia,,1,0,1,1,0,1,0,0,0,0,0,0,15,0
FogoProfeta,FogoProfeta,,0,4,4,0,8,8,1,1,1,0,312,0,4481,0
geglobo,geglobo,,1,0,1,2,0,2,0,0,0,0,312,0,4480,0
BandJornalismo,BandJornalismo,,1,0,1,2,0,2,0,0,0,0,312,0,4479,0
alertario24hrs,alertario24hrs,,1,0,1,2,0,2,0,0,0,0,312,0,4478,0
gilson10313597,gilson10313597,,0,1,1,0,1,1,1,1,1,0,308,262,4482,0
Marcelovishh,Marcelovishh,,0,1,1,0,1,1,1,1,1,0,29,0,4483,0
BRsemgolpe,BRsemgolpe,,0,1,1,0,1,1,2,0.666667,0.75,0,0,0,4484,0
CGUonline,CGUonline,,1,0,1,1,0,1,0,0,0,0,5,0,130,0
policiafederal,policiafederal,,1,0,1,1,0,1,0,0,0,0,5,0,129,0
MPF_PGR,MPF_PGR,,1,0,1,1,0,1,0,0,0,0,5,0,128,0
Die_Primel,Die_Primel,,0,1,1,0,1,1,1,1,1,0,61,37,4485,0
umbertonh_nunez,umbertonh_nunez,,0,1,1,0,1,1,1,1,1,0,29,0,4486,0
